gameId,blueWins,blueWardsPlaced,blueWardsDestroyed,blueFirstBlood,blueKills,blueDeaths,blueAssists,blueEliteMonsters,blueDragons,blueHeralds,blueTowersDestroyed,blueTotalGold,blueAvgLevel,blueTotalExperience,blueTotalMinionsKilled,blueTotalJungleMinionsKilled,blueGoldDiff,blueExperienceDiff,blueCSPerMin,blueGoldPerMin,redWardsPlaced,redWardsDestroyed,redFirstBlood,redKills,redDeaths,redAssists,redEliteMonsters,redDragons,redHeralds,redTowersDestroyed,redTotalGold,redAvgLevel,redTotalExperience,redTotalMinionsKilled,redTotalJungleMinionsKilled,redGoldDiff,redExperienceDiff,redCSPerMin,redGoldPerMin
4436906182,1,13,1,1,4,6,5,0,0,0,0,15420,6.8,16822,235,41,-1633,-2918,23.5,1542.0,17,2,0,6,4,5,1,0,1,0,17053,7.4,19740,253,52,1633,2918,25.3,1705.3
4514312367,0,11,1,0,3,9,5,0,0,0,0,14347,6.4,15496,182,53,-3221,-2950,18.2,1434.7,18,1,1,9,3,14,1,1,0,0,17568,7.2,18446,192,70,3221,2950,19.2,1756.8
4515527717,1,16,3,1,7,8,7,1,1,0,0,17442,6.8,17426,236,36,153,-519,23.6,1744.2,18,3,0,8,7,8,0,0,0,0,17289,6.8,17945,226,48,-153,519,22.6,1728.9
4510817893,0,51,10,1,7,5,8,0,0,0,0,17149,7.0,17975,247,45,1547,611,24.7,1714.9,23,5,0,5,7,8,0,0,0,0,15602,6.8,17364,210,58,-1547,-611,21.0,1560.2
4506258913,1,13,2,1,8,4,11,0,0,0,0,18343,6.8,18609,246,56,3314,2262,24.6,1834.3,15,1,0,4,8,4,0,0,0,0,15029,6.6,16347,204,36,-3314,-2262,20.4,1502.9
4523279887,0,15,4,0,8,6,10,0,0,0,0,16325,6.8,17831,193,40,2,-345,19.3,1632.5,24,1,1,6,8,4,1,1,0,0,16323,7.0,18176,227,48,-2,345,22.7,1632.3
4426693677,0,20,4,1,15,6,12,0,0,0,0,18863,7.2,18943,195,52,2789,585,19.5,1886.3,38,4,0,6,15,4,0,0,0,0,16074,7.0,18358,192,52,-2789,-585,19.2,1607.4
4515178661,0,18,4,1,5,4,5,1,0,1,0,16313,6.8,17999,234,45,-220,67,23.4,1631.3,35,4,0,4,5,5,1,1,0,0,16533,7.2,17932,232,48,220,-67,23.2,1653.3
4458785938,0,12,1,0,3,9,3,0,0,0,0,14851,6.6,16367,183,66,-3151,-3729,18.3,1485.1,15,1,1,9,3,9,0,0,0,0,18002,7.4,20096,207,46,3151,3729,20.7,1800.2
4527229646,0,42,2,0,5,6,3,0,0,0,0,16225,7.0,18754,219,54,-38,1167,21.9,1622.5,15,0,1,6,5,8,0,0,0,0,16263,6.8,17587,239,32,38,-1167,23.9,1626.3
4489981636,1,18,3,0,5,7,6,0,0,0,0,16150,6.8,16981,207,55,-1166,-988,20.7,1615.0,17,5,1,7,5,12,1,1,0,0,17316,7.0,17969,218,60,1166,988,21.8,1731.6
4447744489,1,21,1,1,9,5,10,0,0,0,0,18280,7.0,18115,229,35,4051,1394,22.9,1828.0,19,5,0,5,9,3,1,1,0,0,14229,6.6,16721,211,36,-4051,-1394,21.1,1422.9
4526382734,0,11,2,0,4,8,4,0,0,0,0,15700,7.2,17892,190,59,-2943,-1203,19.0,1570.0,14,1,1,8,4,6,2,1,1,1,18643,7.2,19095,225,45,2943,1203,22.5,1864.3
4511522189,0,17,6,1,5,5,4,1,1,0,0,15706,6.8,18183,219,48,-578,-1149,21.9,1570.6,21,2,0,5,5,2,0,0,0,0,16284,7.2,19332,240,60,578,1149,24.0,1628.4
4513334307,0,12,0,0,1,6,0,0,0,0,0,14748,6.8,17867,212,61,-2619,-1215,21.2,1474.8,45,0,1,6,1,8,1,1,0,0,17367,7.2,19082,237,65,2619,1215,23.7,1736.7
4468111504,1,19,1,1,10,6,12,2,1,1,0,17706,7.0,18096,214,41,145,-1102,21.4,1770.6,9,3,0,6,10,8,0,0,0,0,17561,7.0,19198,221,64,-145,1102,22.1,1756.1
4509730924,1,16,1,0,7,5,8,0,0,0,0,16294,6.8,18342,214,50,-18,252,21.4,1629.4,17,1,1,5,7,4,0,0,0,0,16312,7.0,18090,229,45,18,-252,22.9,1631.2
4517708245,1,15,2,1,4,12,7,0,0,0,0,15123,6.6,15874,169,48,-4949,-3427,16.9,1512.3,16,4,0,12,4,14,2,1,1,1,20072,7.2,19301,221,56,4949,3427,22.1,2007.2
4477545606,0,14,2,0,10,14,6,0,0,0,0,16665,6.8,17063,189,26,-3701,-2739,18.9,1666.5,12,1,1,14,10,11,1,1,0,0,20366,7.4,19802,220,54,3701,2739,22.0,2036.6
4501319968,0,19,3,1,7,4,9,0,0,0,0,17226,7.0,18982,228,61,1857,2015,22.8,1722.6,14,4,0,4,7,2,1,1,0,0,15369,6.6,16967,202,49,-1857,-2015,20.2,1536.9
4515517372,1,17,5,0,2,2,2,0,0,0,0,15423,6.8,18333,227,60,699,753,22.7,1542.3,16,2,1,2,2,3,1,1,0,0,14724,6.8,17580,232,46,-699,-753,23.2,1472.4
4520400316,1,18,2,0,5,4,6,1,1,0,0,16610,7.0,17963,263,40,828,-804,26.3,1661.0,101,4,1,4,5,3,0,0,0,0,15782,7.2,18767,243,64,-828,804,24.3,1578.2
4499715260,0,5,0,0,2,15,2,0,0,0,0,13462,5.4,12212,130,42,-9152,-8290,13.0,1346.2,17,1,1,15,2,12,0,0,0,1,22614,7.4,20502,247,80,9152,8290,24.7,2261.4
4526978661,1,15,3,1,6,2,4,1,0,1,0,16127,6.8,17096,237,40,2329,1331,23.7,1612.7,17,2,0,2,6,4,1,1,0,0,13798,6.2,15765,186,47,-2329,-1331,18.6,1379.8
4509254722,1,13,3,0,6,10,6,1,1,0,0,16279,7.0,18734,226,56,-1753,-1095,22.6,1627.9,16,5,1,10,6,6,0,0,0,0,18032,7.0,19829,253,52,1753,1095,25.3,1803.2
4501853954,1,13,18,1,8,2,8,0,0,0,0,17263,7.0,18277,222,41,2622,1080,22.2,1726.3,37,1,0,2,8,0,1,1,0,0,14641,6.8,17197,212,54,-2622,-1080,21.2,1464.1
4498735941,0,14,1,0,7,8,8,1,0,1,0,17127,7.0,17974,243,45,-373,-212,24.3,1712.7,19,2,1,8,7,10,1,1,0,0,17500,7.0,18186,229,47,373,212,22.9,1750.0
4520639515,0,15,7,0,7,10,5,1,0,1,0,17119,6.8,18614,216,44,-977,271,21.6,1711.9,18,3,1,10,7,12,1,1,0,0,18096,7.0,18343,215,55,977,-271,21.5,1809.6
4521010137,0,16,4,1,8,5,7,0,0,0,0,17044,6.8,17686,217,46,845,-234,21.7,1704.4,14,1,0,5,8,5,1,1,0,0,16199,6.8,17920,207,60,-845,234,20.7,1619.9
4527289759,1,18,2,0,2,4,1,0,0,0,0,13995,7.0,17605,176,71,-1171,-854,17.6,1399.5,51,5,1,4,2,6,1,1,0,0,15166,7.0,18459,218,64,1171,854,21.8,1516.6
4457799018,0,10,1,0,5,10,4,0,0,0,0,14750,6.6,15820,185,44,-3688,-4038,18.5,1475.0,76,1,1,10,5,12,2,1,1,0,18438,7.2,19858,189,60,3688,4038,18.9,1843.8
4518754842,1,38,4,1,8,3,6,2,1,1,0,17848,7.4,19823,253,56,2450,2233,25.3,1784.8,12,3,0,3,8,3,0,0,0,0,15398,7.0,17590,227,52,-2450,-2233,22.7,1539.8
4511816090,0,18,1,1,2,2,3,1,0,1,0,15736,7.0,18218,234,60,705,-208,23.4,1573.6,16,1,0,2,2,2,1,1,0,0,15031,7.0,18426,250,59,-705,208,25.0,1503.1
4464530205,0,16,5,0,5,8,5,0,0,0,0,15649,7.0,17079,201,51,-934,-732,20.1,1564.9,17,4,1,8,5,11,1,1,0,0,16583,6.8,17811,216,48,934,732,21.6,1658.3
4493638317,1,14,5,0,3,4,2,1,0,1,0,15318,6.8,17968,235,49,-942,120,23.5,1531.8,16,2,1,4,3,5,1,1,0,0,16260,6.8,17848,263,44,942,-120,26.3,1626.0
4526394559,0,15,3,1,6,6,9,1,1,0,0,15602,6.6,16235,195,48,-1081,-2155,19.5,1560.2,12,3,0,6,6,4,0,0,0,0,16683,7.0,18390,214,48,1081,2155,21.4,1668.3
4470192893,0,13,1,1,3,9,4,1,1,0,0,15009,6.8,17067,207,56,-2492,-1526,20.7,1500.9,16,1,0,9,3,13,0,0,0,0,17501,7.4,18593,204,50,2492,1526,20.4,1750.1
4501240960,1,16,2,0,5,5,6,1,1,0,0,16046,6.8,17207,234,41,699,18,23.4,1604.6,14,0,1,5,5,6,0,0,0,0,15347,6.6,17189,199,52,-699,-18,19.9,1534.7
4524209230,1,9,1,1,7,2,10,2,1,1,0,18507,7.2,19423,245,52,3756,1754,24.5,1850.7,16,1,0,2,7,3,0,0,0,0,14751,6.6,17669,247,48,-3756,-1754,24.7,1475.1
4439065205,0,28,3,0,6,9,9,0,0,0,0,16552,7.0,17597,215,48,-1026,-982,21.5,1655.2,19,3,1,9,6,7,1,1,0,0,17578,7.0,18579,234,52,1026,982,23.4,1757.8
4477855283,1,18,2,1,15,7,17,1,1,0,1,20932,7.2,19304,233,48,4217,1384,23.3,2093.2,32,4,0,7,15,8,0,0,0,0,16715,7.0,17920,188,64,-4217,-1384,18.8,1671.5
4463171259,0,14,3,0,7,10,4,2,1,1,1,17023,6.4,16951,201,44,-1148,-2197,20.1,1702.3,18,1,1,10,7,8,0,0,0,0,18171,7.2,19148,226,43,1148,2197,22.6,1817.1
4523105100,0,12,5,1,2,6,1,0,0,0,0,14417,6.6,16652,198,60,-1930,-2043,19.8,1441.7,17,2,0,6,2,7,1,1,0,0,16347,7.2,18695,223,53,1930,2043,22.3,1634.7
4518881897,1,16,1,1,7,6,5,0,0,0,0,16345,6.6,16530,204,47,-323,-992,20.4,1634.5,54,2,0,6,7,8,1,1,0,0,16668,7.0,17522,190,56,323,992,19.0,1666.8
4421884287,1,19,5,1,9,8,19,1,1,0,0,18401,7.0,18207,237,51,506,620,23.7,1840.1,15,4,0,8,9,13,0,0,0,0,17895,7.0,17587,239,44,-506,-620,23.9,1789.5
4519053131,0,17,2,1,13,5,16,0,0,0,0,19336,7.2,19116,212,30,4627,4784,21.2,1933.6,14,3,0,5,13,6,0,0,0,0,14709,6.0,14332,175,29,-4627,-4784,17.5,1470.9
4527127761,1,17,3,1,4,4,3,0,0,0,0,15812,7.0,17970,241,42,650,128,24.1,1581.2,11,0,0,4,4,4,1,1,0,0,15162,6.8,17842,198,67,-650,-128,19.8,1516.2
4523342801,1,41,1,0,2,3,1,1,1,0,0,14756,7.2,18676,237,64,-1318,132,23.7,1475.6,17,5,1,3,2,5,0,0,0,0,16074,6.8,18544,266,38,1318,-132,26.6,1607.4
4495119818,1,18,1,1,4,4,9,1,0,1,0,15405,6.8,17336,215,57,-601,-1965,21.5,1540.5,16,1,0,4,4,5,1,1,0,0,16006,7.2,19301,249,71,601,1965,24.9,1600.6
4513110398,1,19,1,0,5,6,3,1,1,0,0,14820,6.4,16224,167,47,-1671,-1100,16.7,1482.0,17,4,1,6,5,10,0,0,0,0,16491,6.8,17324,223,52,1671,1100,22.3,1649.1
4518966647,0,12,2,0,3,7,2,1,1,0,0,14663,6.8,17795,206,59,-1984,-715,20.6,1466.3,13,1,1,7,3,9,0,0,0,0,16647,7.0,18510,205,52,1984,715,20.5,1664.7
4489079383,1,16,3,0,5,5,7,1,1,0,0,15441,6.6,17550,201,52,-575,-208,20.1,1544.1,18,1,1,5,5,3,0,0,0,0,16016,6.8,17758,213,64,575,208,21.3,1601.6
4516073213,1,10,1,1,8,7,5,1,1,0,0,17325,7.0,19648,246,55,744,1657,24.6,1732.5,15,0,0,7,8,6,1,0,1,0,16581,6.8,17991,216,36,-744,-1657,21.6,1658.1
4487632164,1,17,5,1,11,7,12,0,0,0,0,19308,7.2,18764,243,49,2036,2183,24.3,1930.8,17,2,0,7,11,9,0,0,0,0,17272,6.6,16581,164,44,-2036,-2183,16.4,1727.2
4523512356,1,12,1,0,8,6,14,1,1,0,0,16980,6.8,18629,218,48,-53,559,21.8,1698.0,19,2,1,6,8,4,0,0,0,0,17033,7.0,18070,240,59,53,-559,24.0,1703.3
4524882878,1,18,2,1,7,5,5,1,1,0,0,16496,7.0,18201,202,55,1744,1187,20.2,1649.6,15,5,0,5,7,5,0,0,0,0,14752,6.6,17014,209,36,-1744,-1187,20.9,1475.2
4449918896,0,13,2,1,10,4,7,0,0,0,0,17498,7.4,19402,224,45,2084,2869,22.4,1749.8,10,2,0,4,10,4,0,0,0,0,15414,6.4,16533,228,36,-2084,-2869,22.8,1541.4
4516105924,0,39,5,1,10,5,13,0,0,0,0,18866,7.4,19651,252,51,3412,2086,25.2,1886.6,18,3,0,5,10,8,0,0,0,0,15454,7.0,17565,207,49,-3412,-2086,20.7,1545.4
4460835266,1,16,2,0,9,7,15,1,1,0,0,17088,7.0,17650,179,40,262,-229,17.9,1708.8,16,3,1,7,9,9,0,0,0,0,16826,7.0,17879,222,56,-262,229,22.2,1682.6
4465307866,1,16,2,1,9,6,10,1,0,1,0,17704,7.0,18715,197,64,1792,1373,19.7,1770.4,14,1,0,6,9,2,1,1,0,0,15912,6.6,17342,205,48,-1792,-1373,20.5,1591.2
4484202085,0,41,3,1,9,9,13,1,1,0,0,17641,6.8,16803,199,38,436,338,19.9,1764.1,18,5,0,9,9,11,0,0,0,0,17205,6.4,16465,207,33,-436,-338,20.7,1720.5
4450708282,1,13,2,0,11,4,9,1,0,1,0,17666,7.4,19949,218,45,2405,3251,21.8,1766.6,16,3,1,4,11,4,1,1,0,0,15261,6.6,16698,204,45,-2405,-3251,20.4,1526.1
4489679008,1,16,2,0,3,4,0,0,0,0,0,15139,6.8,17354,240,48,-243,799,24.0,1513.9,17,1,1,4,3,10,1,1,0,0,15382,6.6,16555,206,52,243,-799,20.6,1538.2
4508400080,0,13,1,1,7,7,7,1,0,1,0,17214,7.2,18232,219,44,1465,1232,21.9,1721.4,23,1,0,7,7,4,1,1,0,0,15749,6.8,17000,193,49,-1465,-1232,19.3,1574.9
4524429055,0,19,2,1,4,0,2,2,1,1,0,16124,7.4,18986,244,76,2186,1319,24.4,1612.4,18,3,0,0,4,0,0,0,0,0,13938,6.8,17667,241,51,-2186,-1319,24.1,1393.8
4518263954,0,15,1,1,8,3,13,0,0,0,0,18509,7.0,18932,270,36,3602,274,27.0,1850.9,12,3,0,3,8,3,1,1,0,0,14907,7.0,18658,217,62,-3602,-274,21.7,1490.7
4521716722,1,17,1,1,4,8,2,0,0,0,0,16152,7.0,18347,212,59,-633,-502,21.2,1615.2,139,2,0,8,4,14,1,1,0,0,16785,7.0,18849,196,53,633,502,19.6,1678.5
4524775496,1,12,1,0,8,7,9,1,1,0,0,17738,7.2,18849,209,63,1868,1432,20.9,1773.8,17,2,1,7,8,3,0,0,0,0,15870,7.0,17417,207,49,-1868,-1432,20.7,1587.0
4508411042,0,17,3,0,6,13,6,0,0,0,0,15166,6.6,15761,162,44,-3865,-2920,16.2,1516.6,21,2,1,13,6,17,1,1,0,0,19031,7.0,18681,204,52,3865,2920,20.4,1903.1
4524850918,1,38,4,1,8,9,10,1,0,1,0,17558,6.8,17905,202,44,-483,-427,20.2,1755.8,56,4,0,9,8,9,1,1,0,0,18041,7.2,18332,205,48,483,427,20.5,1804.1
4486112923,0,15,2,0,2,7,2,1,0,1,0,14864,6.6,16742,249,41,-2219,-1498,24.9,1486.4,19,3,1,7,2,15,1,1,0,0,17083,7.0,18240,229,52,2219,1498,22.9,1708.3
4526157711,1,52,1,1,9,1,13,2,1,1,0,18159,6.6,16870,217,59,5302,3045,21.7,1815.9,13,0,0,1,9,2,0,0,0,0,12857,6.0,13825,147,48,-5302,-3045,14.7,1285.7
4441440280,0,36,1,0,8,4,6,0,0,0,0,17235,7.0,18992,214,52,2203,2404,21.4,1723.5,14,0,1,4,8,5,1,1,0,0,15032,6.6,16588,205,44,-2203,-2404,20.5,1503.2
4423795870,1,17,4,0,5,7,6,0,0,0,0,15778,6.8,17304,235,40,-1829,-1429,23.5,1577.8,23,3,1,7,5,3,1,1,0,1,17607,6.8,18733,244,51,1829,1429,24.4,1760.7
4519801984,0,18,1,1,7,7,6,1,1,0,0,15927,6.6,15756,192,44,-2390,-2971,19.2,1592.7,13,2,0,7,7,13,0,0,0,0,18317,7.2,18727,219,70,2390,2971,21.9,1831.7
4452966828,0,23,6,1,6,7,9,0,0,0,0,16660,6.8,17061,210,56,99,-1609,21.0,1666.0,20,0,0,7,6,3,1,1,0,0,16561,7.0,18670,214,38,-99,1609,21.4,1656.1
4454378934,0,19,3,1,9,8,12,0,0,0,0,17083,6.6,17538,183,33,67,-820,18.3,1708.3,16,2,0,8,9,5,1,1,0,0,17016,7.0,18358,225,44,-67,820,22.5,1701.6
4519568140,0,16,0,0,4,8,5,0,0,0,0,14763,6.6,16159,205,44,-3584,-2457,20.5,1476.3,11,5,1,8,4,13,1,1,0,0,18347,7.0,18616,254,54,3584,2457,25.4,1834.7
4527378192,0,44,5,1,9,8,9,1,1,0,0,17375,7.2,18906,210,46,-522,269,21.0,1737.5,16,0,0,8,9,7,1,0,1,1,17897,7.0,18637,190,46,522,-269,19.0,1789.7
4426118717,0,18,5,1,8,3,14,1,1,0,0,17160,7.0,17725,191,66,2841,1484,19.1,1716.0,18,3,0,3,8,1,0,0,0,0,14319,6.6,16241,208,57,-2841,-1484,20.8,1431.9
4508272671,1,14,4,1,9,5,11,1,1,0,0,17120,7.0,17636,163,56,1426,128,16.3,1712.0,18,3,0,5,9,2,0,0,0,0,15694,6.8,17508,207,52,-1426,-128,20.7,1569.4
4518711982,1,15,2,1,9,3,9,0,0,0,0,17438,7.0,18257,186,48,3018,1995,18.6,1743.8,19,1,0,3,9,3,0,0,0,0,14420,6.6,16262,222,39,-3018,-1995,22.2,1442.0
4506113045,1,20,1,1,6,6,5,0,0,0,0,16291,6.8,18130,228,44,164,-222,22.8,1629.1,13,3,0,6,6,6,0,0,0,0,16127,7.0,18352,227,40,-164,222,22.7,1612.7
4502288347,1,102,2,1,6,7,3,1,1,0,0,17303,7.0,18417,224,52,572,417,22.4,1730.3,13,12,0,7,6,7,0,0,0,0,16731,7.0,18000,205,60,-572,-417,20.5,1673.1
4468160343,0,20,3,0,2,6,2,1,0,1,0,14869,6.8,17895,238,41,-1642,-703,23.8,1486.9,17,1,1,6,2,8,1,1,0,0,16511,7.2,18598,224,59,1642,703,22.4,1651.1
4495582337,1,10,2,0,9,1,13,1,0,1,0,17329,7.0,18182,189,56,2252,1086,18.9,1732.9,16,3,1,1,9,2,0,0,0,0,15077,7.0,17096,244,58,-2252,-1086,24.4,1507.7
4479804307,1,16,2,1,10,6,12,1,1,0,0,18439,7.2,18689,223,39,1894,99,22.3,1843.9,12,4,0,6,10,5,0,0,0,0,16545,7.0,18590,203,48,-1894,-99,20.3,1654.5
4519842459,1,15,3,1,11,4,15,0,0,0,0,19432,7.2,19227,228,43,3857,2660,22.8,1943.2,19,2,0,4,11,6,1,1,0,0,15575,6.6,16567,210,53,-3857,-2660,21.0,1557.5
4515397290,1,21,1,0,5,10,8,1,1,0,0,16408,7.0,18014,228,42,-2936,-1305,22.8,1640.8,18,2,1,10,5,17,0,0,0,0,19344,7.0,19319,232,68,2936,1305,23.2,1934.4
4522461341,0,15,13,0,3,9,1,1,1,0,0,14711,6.8,18284,204,52,-3559,-1400,20.4,1471.1,42,3,1,9,3,7,0,0,0,0,18270,7.2,19684,256,43,3559,1400,25.6,1827.0
4496792553,1,16,3,0,8,7,13,0,0,0,0,16366,6.8,17010,196,34,-963,-457,19.6,1636.6,16,2,1,7,8,8,0,0,0,0,17329,7.0,17467,220,52,963,457,22.0,1732.9
4518235291,0,14,3,0,6,6,7,1,1,0,0,15814,6.8,17161,205,49,-1530,-922,20.5,1581.4,20,2,1,6,6,6,1,0,1,0,17344,7.0,18083,252,48,1530,922,25.2,1734.4
4486208789,1,18,3,0,3,7,4,0,0,0,0,13991,6.4,16073,203,21,-3756,-3280,20.3,1399.1,48,8,1,7,3,4,0,0,0,0,17747,7.2,19353,256,53,3756,3280,25.6,1774.7
4527674741,0,17,5,1,3,3,5,1,0,1,0,15079,6.6,15930,212,44,607,-1168,21.2,1507.9,55,3,0,3,3,5,1,1,0,0,14472,6.8,17098,210,38,-607,1168,21.0,1447.2
4500339262,1,12,2,1,7,4,7,1,0,1,0,18821,7.2,19339,259,68,4074,2842,25.9,1882.1,13,1,0,4,7,6,0,0,0,0,14747,6.4,16497,189,36,-4074,-2842,18.9,1474.7
4521787222,0,16,3,0,4,6,2,2,1,1,0,14975,7.0,18139,201,58,-1530,-146,20.1,1497.5,40,5,1,6,4,8,0,0,0,0,16505,7.2,18285,220,63,1530,146,22.0,1650.5
4514736409,1,12,2,1,10,7,11,0,0,0,0,17938,6.8,17865,219,37,2161,1731,21.9,1793.8,15,1,0,7,10,6,1,1,0,0,15777,6.2,16134,195,55,-2161,-1731,19.5,1577.7
4509204216,0,13,0,0,3,8,2,0,0,0,0,14500,6.6,16097,209,50,-3614,-3434,20.9,1450.0,16,1,1,8,3,10,1,0,1,0,18114,7.2,19531,222,60,3614,3434,22.2,1811.4
4515883864,1,15,4,1,8,4,9,1,1,0,0,16955,6.8,17434,191,56,1306,1039,19.1,1695.5,16,0,0,4,8,2,0,0,0,0,15649,6.6,16395,200,48,-1306,-1039,20.0,1564.9
4500841248,0,39,0,0,7,6,7,1,1,0,0,16438,7.0,17815,214,37,-370,-1681,21.4,1643.8,14,1,1,6,7,7,1,0,1,0,16808,7.4,19496,234,51,370,1681,23.4,1680.8
4525623416,0,21,1,0,2,6,2,1,1,0,0,14294,6.6,17461,220,61,-2820,-2226,22.0,1429.4,14,0,1,6,2,5,1,0,1,0,17114,7.4,19687,236,49,2820,2226,23.6,1711.4
4382920718,1,21,3,0,15,16,10,2,1,1,0,19247,6.8,16835,205,44,-1709,-1585,20.5,1924.7,80,6,1,16,15,16,0,0,0,0,20956,7.0,18420,182,44,1709,1585,18.2,2095.6
4524577169,1,20,5,1,9,8,13,1,1,0,0,17283,6.6,16810,205,28,-428,5,20.5,1728.3,18,3,0,8,9,7,1,0,1,0,17711,6.6,16805,213,36,428,-5,21.3,1771.1
4516036728,1,14,4,1,7,6,7,2,1,1,0,17588,7.0,18328,233,63,1219,292,23.3,1758.8,15,2,0,6,7,10,0,0,0,0,16369,6.8,18036,216,45,-1219,-292,21.6,1636.9
4457232742,1,15,2,1,11,3,13,1,1,0,0,17655,7.2,18905,208,44,1906,1369,20.8,1765.5,13,0,0,3,11,3,0,0,0,0,15749,7.0,17536,221,57,-1906,-1369,22.1,1574.9
4517834263,1,14,1,1,8,6,8,0,0,0,0,17915,7.2,19197,215,56,1451,1985,21.5,1791.5,15,1,0,6,8,9,0,0,0,0,16464,7.0,17212,222,47,-1451,-1985,22.2,1646.4
4484301779,1,20,2,1,3,4,6,0,0,0,0,14632,6.4,16037,198,53,-1134,-906,19.8,1463.2,15,4,0,4,3,5,1,0,1,0,15766,6.8,16943,223,46,1134,906,22.3,1576.6
4523038928,1,13,2,1,5,1,4,1,1,0,0,16733,7.2,19451,232,62,2685,2307,23.2,1673.3,20,1,0,1,5,2,0,0,0,0,14048,6.8,17144,207,63,-2685,-2307,20.7,1404.8
4483893838,1,16,1,1,8,9,14,2,1,1,0,18532,7.2,18460,240,55,1428,295,24.0,1853.2,17,1,0,9,8,9,0,0,0,0,17104,7.0,18165,201,48,-1428,-295,20.1,1710.4
4462313921,1,57,4,1,17,5,25,0,0,0,2,23359,7.4,20348,237,56,7776,6703,23.7,2335.9,14,5,0,5,17,7,0,0,0,0,15583,5.8,13645,134,41,-7776,-6703,13.4,1558.3
4494893980,0,17,0,0,4,5,3,1,1,0,0,15041,7.0,16622,214,43,-1207,-1748,21.4,1504.1,13,3,1,5,4,3,0,0,0,0,16248,7.0,18370,228,60,1207,1748,22.8,1624.8
4484294172,0,14,2,0,5,6,0,1,1,0,0,15682,7.0,18027,247,44,-438,-778,24.7,1568.2,47,0,1,6,5,6,0,0,0,0,16120,7.0,18805,206,51,438,778,20.6,1612.0
4510792748,0,18,3,0,3,6,3,0,0,0,0,14649,6.6,15693,200,48,-1945,-2496,20.0,1464.9,13,3,1,6,3,7,1,1,0,0,16594,7.0,18189,216,61,1945,2496,21.6,1659.4
4507962788,1,19,2,1,3,6,2,2,1,1,0,15032,6.8,18187,207,65,-1920,-363,20.7,1503.2,15,3,0,6,3,8,0,0,0,0,16952,7.0,18550,246,53,1920,363,24.6,1695.2
4517035921,1,17,2,0,6,4,8,1,1,0,0,16623,7.0,18012,243,48,598,-456,24.3,1662.3,16,3,1,4,6,1,1,0,1,0,16025,7.0,18468,224,56,-598,456,22.4,1602.5
4514106633,0,15,2,1,5,5,5,0,0,0,0,15734,7.0,17911,213,47,-837,-660,21.3,1573.4,21,3,0,5,5,7,2,1,1,0,16571,7.0,18571,249,47,837,660,24.9,1657.1
4523524261,1,20,1,1,7,4,3,1,1,0,0,17120,6.8,18300,233,59,1936,1098,23.3,1712.0,12,4,0,4,7,4,0,0,0,0,15184,6.8,17202,206,50,-1936,-1098,20.6,1518.4
4524116491,1,12,2,0,5,9,8,0,0,0,0,16095,6.8,17192,222,50,-1905,-2185,22.2,1609.5,13,0,1,9,5,12,0,0,0,0,18000,7.2,19377,217,64,1905,2185,21.7,1800.0
4524994987,1,18,0,1,14,4,15,0,0,0,0,20075,7.0,18552,220,53,5853,3870,22.0,2007.5,15,0,0,4,14,6,0,0,0,0,14222,6.2,14682,179,36,-5853,-3870,17.9,1422.2
4461618866,1,18,2,1,3,3,3,1,1,0,0,15923,7.0,18062,248,50,1916,1404,24.8,1592.3,17,3,0,3,3,3,1,0,1,0,14007,6.8,16658,193,40,-1916,-1404,19.3,1400.7
4491423800,0,16,0,0,6,8,5,1,1,0,0,15683,7.0,17335,186,54,-1906,-1476,18.6,1568.3,12,3,1,8,6,9,1,0,1,0,17589,7.0,18811,240,45,1906,1476,24.0,1758.9
4525860232,1,17,2,0,9,6,9,0,0,0,0,17643,6.8,17908,218,36,1550,1042,21.8,1764.3,36,1,1,6,9,8,2,1,1,0,16093,6.6,16866,183,52,-1550,-1042,18.3,1609.3
4524417546,1,11,2,0,3,5,5,1,1,0,0,15310,7.2,18085,228,52,-354,-8,22.8,1531.0,61,2,1,5,3,2,0,0,0,0,15664,7.0,18093,239,43,354,8,23.9,1566.4
4525946644,0,18,1,0,4,8,5,1,1,0,0,15901,7.0,18666,245,60,-2522,-1763,24.5,1590.1,12,2,1,8,4,7,0,0,0,0,18423,7.6,20429,250,68,2522,1763,25.0,1842.3
4523425333,0,21,5,0,4,5,4,0,0,0,0,15564,6.8,17895,216,59,-433,445,21.6,1556.4,16,5,1,5,4,7,1,1,0,0,15997,6.8,17450,225,52,433,-445,22.5,1599.7
4515233268,1,14,4,1,7,7,7,2,1,1,0,17381,7.2,20017,221,76,1542,2179,22.1,1738.1,17,2,0,7,7,4,0,0,0,0,15839,7.0,17838,204,48,-1542,-2179,20.4,1583.9
4464340157,0,13,0,0,5,12,11,1,1,0,0,14353,6.2,15067,168,48,-4550,-3483,16.8,1435.3,11,1,1,12,5,19,0,0,0,0,18903,7.2,18550,216,39,4550,3483,21.6,1890.3
4503341875,0,22,2,1,9,7,10,0,0,0,0,18400,7.2,18909,221,60,2746,1975,22.1,1840.0,39,1,0,7,9,10,1,1,0,0,15654,6.6,16934,164,52,-2746,-1975,16.4,1565.4
4500727933,0,17,2,1,2,2,1,1,0,1,0,14687,6.8,17701,234,53,-668,-300,23.4,1468.7,32,5,0,2,2,2,0,0,0,0,15355,6.8,18001,255,48,668,300,25.5,1535.5
4467235457,0,13,2,1,3,9,3,0,0,0,0,14797,6.6,17124,212,48,-3268,-3888,21.2,1479.7,13,2,0,9,3,6,1,1,0,0,18065,7.6,21012,218,80,3268,3888,21.8,1806.5
4520968733,1,61,3,0,5,7,5,0,0,0,0,16343,6.8,18250,233,52,77,239,23.3,1634.3,17,4,1,7,5,9,1,1,0,0,16266,6.8,18011,203,52,-77,-239,20.3,1626.6
4515778115,0,16,2,0,7,8,12,0,0,0,0,17737,7.0,18616,234,44,648,617,23.4,1773.7,15,4,1,8,7,10,1,1,0,0,17089,7.0,17999,202,51,-648,-617,20.2,1708.9
4520357816,0,16,1,1,7,4,2,0,0,0,0,15911,7.0,17640,219,38,428,1015,21.9,1591.1,13,1,0,4,7,5,1,1,0,0,15483,6.6,16625,234,45,-428,-1015,23.4,1548.3
4481561513,0,23,4,0,5,5,6,1,1,0,0,16270,7.2,18195,223,54,748,-77,22.3,1627.0,39,7,1,5,5,5,0,0,0,0,15522,6.8,18272,208,55,-748,77,20.8,1552.2
4522519363,1,16,4,0,5,3,4,1,1,0,0,16338,7.2,19137,234,60,1106,1309,23.4,1633.8,18,1,1,3,5,1,0,0,0,0,15232,6.8,17828,228,60,-1106,-1309,22.8,1523.2
4496960681,0,21,8,0,1,12,1,0,0,0,0,13525,6.4,15625,210,46,-5423,-4119,21.0,1352.5,39,6,1,12,1,14,1,1,0,0,18948,7.4,19744,206,46,5423,4119,20.6,1894.8
4496739291,1,16,3,1,10,5,7,1,1,0,0,18240,7.0,19116,259,31,2953,1980,25.9,1824.0,17,2,0,5,10,4,0,0,0,0,15287,6.8,17136,197,64,-2953,-1980,19.7,1528.7
4514329925,1,17,2,0,9,6,6,1,1,0,0,17261,7.0,18577,219,56,1704,2023,21.9,1726.1,15,1,1,6,9,8,0,0,0,0,15557,6.6,16554,182,42,-1704,-2023,18.2,1555.7
4521648781,1,20,3,1,10,6,11,0,0,0,0,19000,7.2,18915,233,39,1259,-60,23.3,1900.0,17,5,0,6,10,7,0,0,0,0,17741,7.0,18975,264,44,-1259,60,26.4,1774.1
4522475843,1,11,0,1,3,5,3,2,1,1,0,15562,6.8,16991,222,52,-1176,-1838,22.2,1556.2,16,2,0,5,3,9,0,0,0,0,16738,7.0,18829,201,68,1176,1838,20.1,1673.8
4527198639,0,16,1,1,4,9,2,0,0,0,0,15285,6.8,16734,194,49,-974,-815,19.4,1528.5,40,3,0,9,4,12,1,1,0,0,16259,6.6,17549,184,33,974,815,18.4,1625.9
4471458377,0,17,3,0,5,9,7,1,0,1,0,16096,7.0,17359,224,45,-581,146,22.4,1609.6,16,2,1,9,5,8,0,0,0,0,16677,6.8,17213,204,43,581,-146,20.4,1667.7
4524074857,1,80,4,0,9,5,6,2,1,1,0,18419,7.6,19957,246,56,1773,1953,24.6,1841.9,13,3,1,5,9,7,0,0,0,0,16646,6.8,18004,244,50,-1773,-1953,24.4,1664.6
4508717967,0,18,2,0,15,6,15,0,0,0,0,19931,7.0,18115,213,40,4375,3249,21.3,1993.1,17,1,1,6,15,6,0,0,0,0,15556,6.2,14866,169,40,-4375,-3249,16.9,1555.6
4527040336,1,16,6,1,5,4,5,0,0,0,0,15452,6.6,16236,195,35,926,-849,19.5,1545.2,17,2,0,4,5,4,1,1,0,0,14526,6.8,17085,186,44,-926,849,18.6,1452.6
4465078328,0,27,2,0,5,4,6,0,0,0,0,15732,6.6,16582,218,44,17,-1014,21.8,1573.2,15,3,1,4,5,4,0,0,0,0,15715,7.0,17596,248,44,-17,1014,24.8,1571.5
4522665247,0,38,2,0,9,15,9,0,0,0,0,17371,6.8,17227,183,42,-2793,-3416,18.3,1737.1,15,3,1,15,9,12,0,0,0,0,20164,7.6,20643,228,42,2793,3416,22.8,2016.4
4525145035,0,12,1,1,6,8,9,0,0,0,0,16480,6.6,17339,226,48,-1726,63,22.6,1648.0,18,2,0,8,6,9,1,0,1,1,18206,6.8,17276,229,26,1726,-63,22.9,1820.6
4513418433,0,18,3,0,7,13,5,0,0,0,0,15744,6.8,16509,201,48,-3762,-1626,20.1,1574.4,17,2,1,13,7,16,2,1,1,0,19506,6.8,18135,213,52,3762,1626,21.3,1950.6
4506933329,1,15,1,0,4,6,2,1,1,0,0,15340,7.2,18245,228,44,-1031,122,22.8,1534.0,13,4,1,6,4,7,0,0,0,0,16371,7.0,18123,228,51,1031,-122,22.8,1637.1
4524387614,1,36,4,1,6,2,4,1,1,0,0,16432,7.4,18849,208,59,2390,1778,20.8,1643.2,15,5,0,2,6,1,0,0,0,0,14042,6.6,17071,219,48,-2390,-1778,21.9,1404.2
4523478431,0,17,4,0,5,7,5,0,0,0,0,15420,6.6,16502,210,44,-692,-604,21.0,1542.0,16,3,1,7,5,7,2,1,1,0,16112,6.8,17106,193,48,692,604,19.3,1611.2
4473800740,1,18,17,1,13,5,11,0,0,0,0,20853,7.6,20248,270,43,5501,3548,27.0,2085.3,43,0,0,5,13,7,0,0,0,0,15352,6.8,16700,188,48,-5501,-3548,18.8,1535.2
4521186750,0,13,3,1,4,4,5,0,0,0,0,15801,7.2,18475,206,65,-187,-361,20.6,1580.1,17,2,0,4,4,3,1,1,0,0,15988,7.2,18836,251,66,187,361,25.1,1598.8
4520919497,0,12,3,0,8,8,8,1,1,0,0,16028,6.6,16233,187,36,-728,-608,18.7,1602.8,16,0,1,8,8,7,0,0,0,0,16756,6.8,16841,184,43,728,608,18.4,1675.6
4525993420,1,26,1,1,6,6,7,1,0,1,1,17312,6.6,16818,209,50,1139,-885,20.9,1731.2,17,2,0,6,6,8,1,1,0,0,16173,6.8,17703,208,52,-1139,885,20.8,1617.3
4413326513,1,35,2,0,3,5,3,0,0,0,0,15908,7.4,18487,220,60,-1194,-1133,22.0,1590.8,17,3,1,5,3,4,1,1,0,0,17102,7.2,19620,255,56,1194,1133,25.5,1710.2
4477261749,0,15,4,0,1,4,1,2,1,1,0,14142,6.8,16922,229,52,-1691,-1608,22.9,1414.2,25,1,1,4,1,4,0,0,0,0,15833,7.0,18530,234,59,1691,1608,23.4,1583.3
4479829925,1,15,5,1,7,2,9,0,0,0,0,17428,7.4,18741,219,56,2444,561,21.9,1742.8,16,2,0,2,7,1,1,1,0,0,14984,6.8,18180,242,52,-2444,-561,24.2,1498.4
4516360817,0,37,6,1,6,8,7,0,0,0,0,16595,7.2,18766,217,57,-829,289,21.7,1659.5,19,1,0,8,6,10,2,1,1,0,17424,7.2,18477,220,62,829,-289,22.0,1742.4
4519052446,1,36,7,1,10,6,11,2,1,1,0,18132,7.6,19522,232,47,1722,1514,23.2,1813.2,20,5,0,6,10,8,0,0,0,0,16410,7.2,18008,211,44,-1722,-1514,21.1,1641.0
4519869638,1,16,4,0,5,9,2,1,1,0,0,15038,6.8,17122,194,45,-2755,-869,19.4,1503.8,22,2,1,9,5,11,0,0,0,0,17793,6.8,17991,218,46,2755,869,21.8,1779.3
4524434375,1,38,4,0,9,9,14,1,1,0,0,17630,7.0,18364,230,50,13,2012,23.0,1763.0,15,2,1,9,9,10,0,0,0,0,17617,6.4,16352,165,42,-13,-2012,16.5,1761.7
4513724737,0,13,6,1,2,5,2,1,1,0,0,14514,7.0,17851,211,63,-1386,-450,21.1,1451.4,39,2,0,5,2,1,0,0,0,0,15900,6.8,18301,242,55,1386,450,24.2,1590.0
4522058891,1,11,1,0,5,6,7,0,0,0,0,15334,6.8,17065,193,45,-2412,-2055,19.3,1533.4,16,2,1,6,5,5,0,0,0,0,17746,7.2,19120,243,54,2412,2055,24.3,1774.6
4486240093,1,18,1,1,8,1,13,1,1,0,0,18078,6.8,18559,247,50,5354,4695,24.7,1807.8,15,4,0,1,8,0,0,0,0,0,12724,6.0,13864,166,46,-5354,-4695,16.6,1272.4
4458380035,1,14,3,1,12,4,13,1,1,0,0,18705,7.4,19808,210,50,3692,4028,21.0,1870.5,12,2,0,4,12,5,0,0,0,0,15013,6.4,15780,219,36,-3692,-4028,21.9,1501.3
4522541186,1,165,3,1,11,8,8,1,1,0,1,19556,7.0,18352,229,41,2585,1759,22.9,1955.6,14,1,0,8,11,9,0,0,0,0,16971,6.6,16593,169,63,-2585,-1759,16.9,1697.1
4521425528,0,15,3,1,7,11,9,1,1,0,0,15363,6.2,15411,171,52,-2151,-852,17.1,1536.3,16,1,0,11,7,9,0,0,0,0,17514,6.4,16263,199,43,2151,852,19.9,1751.4
4417615828,0,14,1,0,6,6,7,1,1,0,0,16642,7.0,18251,218,52,-348,-611,21.8,1664.2,15,0,1,6,6,4,1,0,1,0,16990,7.0,18862,237,40,348,611,23.7,1699.0
4518759823,1,37,3,1,12,5,15,1,1,0,0,19141,7.6,20647,192,60,4294,4438,19.2,1914.1,15,2,0,5,12,3,0,0,0,0,14847,6.4,16209,210,36,-4294,-4438,21.0,1484.7
4467276496,1,36,1,1,5,5,8,0,0,0,0,16192,6.8,18197,209,60,1056,-182,20.9,1619.2,11,1,0,5,5,4,1,1,0,0,15136,7.0,18379,185,46,-1056,182,18.5,1513.6
4475316564,1,13,4,1,7,2,2,1,1,0,0,16116,7.2,19219,246,49,1409,2205,24.6,1611.6,19,0,0,2,7,2,0,0,0,0,14707,6.8,17014,203,51,-1409,-2205,20.3,1470.7
4480350578,1,18,1,1,7,3,6,0,0,0,0,17082,7.2,19192,224,59,2388,1600,22.4,1708.2,36,2,0,3,7,2,1,1,0,0,14694,7.0,17592,224,49,-2388,-1600,22.4,1469.4
4507747871,1,18,1,1,6,5,6,0,0,0,0,16471,6.8,17952,246,36,1450,763,24.6,1647.1,18,2,0,5,6,3,0,0,0,0,15021,6.8,17189,200,40,-1450,-763,20.0,1502.1
4501779329,0,16,4,1,6,5,7,1,0,1,0,16113,6.8,16994,180,41,-1063,-632,18.0,1611.3,18,4,0,5,6,5,0,0,0,1,17176,6.8,17626,240,41,1063,632,24.0,1717.6
4470384241,1,16,3,1,10,4,12,1,1,0,0,18945,7.0,18620,234,44,2542,525,23.4,1894.5,13,2,0,4,10,4,0,0,0,0,16403,6.8,18095,231,76,-2542,-525,23.1,1640.3
4461499793,0,16,3,1,4,4,3,0,0,0,0,16175,6.8,17305,253,48,684,-474,25.3,1617.5,12,1,0,4,4,4,0,0,0,0,15491,7.0,17779,232,46,-684,474,23.2,1549.1
4496724887,1,23,5,1,8,2,13,1,1,0,0,17575,7.2,18579,228,52,2658,1915,22.8,1757.5,18,3,0,2,8,2,0,0,0,0,14917,6.6,16664,211,50,-2658,-1915,21.1,1491.7
4516515397,0,13,1,0,6,12,3,0,0,0,0,15485,6.6,16784,213,28,-3683,-3420,21.3,1548.5,34,3,1,12,6,13,2,1,1,0,19168,7.4,20204,209,63,3683,3420,20.9,1916.8
4463063111,1,38,7,0,2,2,1,0,0,0,0,15782,6.8,18460,253,66,1344,1195,25.3,1578.2,62,2,1,2,2,1,0,0,0,0,14438,6.8,17265,236,52,-1344,-1195,23.6,1443.8
4489141814,0,14,1,0,2,5,4,0,0,0,0,14743,6.8,17174,228,44,-1625,-2061,22.8,1474.3,21,3,1,5,2,8,2,1,1,0,16368,7.4,19235,239,60,1625,2061,23.9,1636.8
4509912325,0,91,6,0,2,7,4,1,1,0,0,14507,6.4,16400,215,52,-2328,-1153,21.5,1450.7,39,4,1,7,2,7,1,0,1,0,16835,6.8,17553,189,52,2328,1153,18.9,1683.5
4439856081,0,16,2,0,4,11,3,0,0,0,0,15098,6.8,18104,225,55,-3779,-1537,22.5,1509.8,12,2,1,11,4,10,2,1,1,0,18877,7.4,19641,227,42,3779,1537,22.7,1887.7
4465212739,0,15,1,1,10,8,12,0,0,0,0,17767,7.4,18168,194,52,163,-368,19.4,1776.7,14,2,0,8,10,13,0,0,0,0,17604,7.0,18536,211,52,-163,368,21.1,1760.4
4464614548,0,12,1,0,2,7,1,1,0,1,0,15051,6.8,17519,220,57,-2815,-1204,22.0,1505.1,16,1,1,7,2,8,0,0,0,0,17866,7.2,18723,236,52,2815,1204,23.6,1786.6
4508648628,0,30,1,0,3,9,2,1,0,1,0,14423,7.2,17518,188,59,-2911,-286,18.8,1442.3,12,1,1,9,3,12,0,0,0,0,17334,6.8,17804,201,38,2911,286,20.1,1733.4
4523847046,1,17,4,1,5,5,5,0,0,0,1,17333,6.8,16881,232,39,781,-1744,23.2,1733.3,18,1,0,5,5,4,1,0,1,0,16552,7.2,18625,234,52,-781,1744,23.4,1655.2
4485749610,1,12,6,0,4,5,5,2,1,1,0,16630,7.2,19373,251,70,-159,-206,25.1,1663.0,22,2,1,5,4,6,0,0,0,0,16789,7.2,19579,244,65,159,206,24.4,1678.9
4523588445,0,15,5,1,4,3,5,1,1,0,0,16116,7.0,17653,244,47,2092,1763,24.4,1611.6,13,2,0,3,4,2,0,0,0,0,14024,6.4,15890,191,48,-2092,-1763,19.1,1402.4
4516268505,1,42,2,1,8,3,6,0,0,0,0,16532,7.2,18420,229,40,1558,785,22.9,1653.2,34,2,0,3,8,2,1,0,1,0,14974,7.0,17635,206,56,-1558,-785,20.6,1497.4
4518214462,1,34,3,1,8,6,5,1,0,1,0,17540,7.4,19850,232,56,1499,2433,23.2,1754.0,15,3,0,6,8,4,0,0,0,0,16041,7.0,17417,187,48,-1499,-2433,18.7,1604.1
4526612665,0,21,3,1,1,1,3,0,0,0,0,15301,7.0,18098,249,72,166,-436,24.9,1530.1,17,4,0,1,1,0,1,1,0,0,15135,6.8,18534,230,60,-166,436,23.0,1513.5
4510100587,0,14,1,0,2,6,3,0,0,0,0,14950,7.0,18134,234,42,-1889,-723,23.4,1495.0,14,1,1,6,2,6,1,1,0,0,16839,7.0,18857,229,49,1889,723,22.9,1683.9
4523093553,1,17,3,1,9,4,8,1,1,0,0,18646,7.6,19823,253,43,3767,3277,25.3,1864.6,11,2,0,4,9,6,0,0,0,0,14879,6.6,16546,195,36,-3767,-3277,19.5,1487.9
4420829528,1,20,7,0,11,4,12,0,0,0,0,19392,7.2,18570,239,48,4872,3076,23.9,1939.2,20,3,1,4,11,6,0,0,0,0,14520,6.2,15494,203,34,-4872,-3076,20.3,1452.0
4523297583,1,38,5,1,4,3,3,2,1,1,0,15211,7.0,18741,200,64,464,1520,20.0,1521.1,16,7,0,3,4,2,0,0,0,0,14747,6.8,17221,242,41,-464,-1520,24.2,1474.7
4511678140,1,16,2,1,7,9,10,1,0,1,1,19036,7.2,19444,248,60,2346,751,24.8,1903.6,37,1,0,9,7,14,1,1,0,0,16690,7.4,18693,197,53,-2346,-751,19.7,1669.0
4524479196,0,11,2,0,1,8,2,0,0,0,0,13841,6.8,16368,216,49,-5048,-4145,21.6,1384.1,18,0,1,8,1,6,1,1,0,0,18889,7.4,20513,268,53,5048,4145,26.8,1888.9
4505375338,1,21,3,0,5,5,8,2,1,1,0,16709,7.0,18855,222,68,728,2095,22.2,1670.9,15,7,1,5,5,8,0,0,0,0,15981,6.8,16760,224,44,-728,-2095,22.4,1598.1
4526463551,1,12,3,0,5,5,9,1,0,1,0,16730,7.0,17875,246,52,913,14,24.6,1673.0,13,1,1,5,5,6,0,0,0,0,15817,6.8,17861,205,55,-913,-14,20.5,1581.7
4505373402,1,17,3,0,6,3,6,0,0,0,0,17671,7.0,18649,250,56,2135,1254,25.0,1767.1,59,4,1,3,6,4,1,1,0,0,15536,7.0,17395,231,52,-2135,-1254,23.1,1553.6
4491522681,0,14,2,0,3,4,2,0,0,0,0,15369,7.0,17785,221,57,-482,-349,22.1,1536.9,19,6,1,4,3,5,1,1,0,0,15851,7.0,18134,257,56,482,349,25.7,1585.1
4518222649,0,14,4,0,5,5,5,1,0,1,0,16115,7.2,18971,237,48,516,2485,23.7,1611.5,19,2,1,5,5,8,0,0,0,0,15599,6.6,16486,213,42,-516,-2485,21.3,1559.9
4524587916,0,26,3,0,2,3,4,0,0,0,0,14680,7.0,17465,207,56,-1602,-1412,20.7,1468.0,16,4,1,3,2,2,2,1,1,0,16282,7.2,18877,243,68,1602,1412,24.3,1628.2
4510552697,1,15,2,1,7,9,7,2,1,1,0,16578,6.8,18186,220,50,-987,-741,22.0,1657.8,18,2,0,9,7,9,0,0,0,0,17565,7.4,18927,206,44,987,741,20.6,1756.5
4522682981,1,14,2,1,10,1,9,0,0,0,0,18324,7.4,19267,199,54,4545,3714,19.9,1832.4,15,1,0,1,10,1,0,0,0,0,13779,6.2,15553,195,46,-4545,-3714,19.5,1377.9
4520615634,1,37,2,1,8,4,11,1,1,0,0,17903,7.2,19715,206,71,1970,1999,20.6,1790.3,14,2,0,4,8,4,0,0,0,0,15933,7.0,17716,234,43,-1970,-1999,23.4,1593.3
4510825805,1,18,2,1,8,2,13,1,1,0,0,17226,7.2,18501,224,52,3923,3613,22.4,1722.6,14,2,0,2,8,3,0,0,0,0,13303,6.0,14888,183,23,-3923,-3613,18.3,1330.3
4488299127,0,14,1,0,2,12,3,0,0,0,0,14579,6.4,15758,196,52,-4225,-2478,19.6,1457.9,10,4,1,12,2,16,0,0,0,0,18804,7.2,18236,230,32,4225,2478,23.0,1880.4
4516641337,0,16,5,1,11,8,14,0,0,0,0,18345,7.2,18508,218,52,1959,899,21.8,1834.5,15,2,0,8,11,10,2,1,1,0,16386,6.8,17609,198,44,-1959,-899,19.8,1638.6
4523251665,0,48,3,0,3,6,6,0,0,0,0,14986,6.8,17222,208,46,-1501,-1478,20.8,1498.6,18,3,1,6,3,4,0,0,0,0,16487,7.2,18700,220,49,1501,1478,22.0,1648.7
4503345780,1,12,3,1,4,2,5,0,0,0,0,16164,7.2,19020,246,46,956,-27,24.6,1616.4,59,1,0,2,4,3,1,1,0,0,15208,7.2,19047,242,73,-956,27,24.2,1520.8
4498444821,1,20,5,1,8,6,9,0,0,0,0,17777,7.4,18847,232,52,1317,1480,23.2,1777.7,15,0,0,6,8,8,1,0,1,0,16460,6.8,17367,202,40,-1317,-1480,20.2,1646.0
4518495220,1,14,0,1,8,8,4,2,1,1,0,16459,6.8,17550,190,48,-335,-213,19.0,1645.9,16,0,0,8,8,7,0,0,0,0,16794,7.0,17763,209,57,335,213,20.9,1679.4
4517773743,0,16,0,1,4,9,1,0,0,0,0,14939,6.8,17241,195,68,-4843,-2306,19.5,1493.9,38,3,0,9,4,17,2,1,1,1,19782,7.0,19547,227,63,4843,2306,22.7,1978.2
4527782537,0,51,3,1,3,6,7,1,1,0,0,14857,6.8,16510,226,43,-959,-1248,22.6,1485.7,29,3,0,6,3,3,1,0,1,0,15816,6.8,17758,195,58,959,1248,19.5,1581.6
4493892937,1,45,4,0,2,8,1,2,1,1,0,14194,6.8,17765,192,62,-1949,-18,19.2,1419.4,19,3,1,8,2,9,0,0,0,0,16143,7.0,17783,190,53,1949,18,19.0,1614.3
4515399183,1,17,0,1,6,9,5,2,1,1,0,16149,6.8,16641,199,52,34,-957,19.9,1614.9,34,3,0,9,6,9,0,0,0,0,16115,6.8,17598,184,28,-34,957,18.4,1611.5
4458991310,0,18,1,1,6,6,5,1,1,0,0,16196,7.2,18801,214,52,-25,954,21.4,1619.6,14,1,0,6,6,8,0,0,0,0,16221,6.8,17847,217,32,25,-954,21.7,1622.1
4522640075,1,55,4,1,8,4,11,0,0,0,0,17064,7.0,18586,207,42,1183,1036,20.7,1706.4,18,1,0,4,8,2,1,0,1,0,15881,7.0,17550,217,54,-1183,-1036,21.7,1588.1
4518121833,1,13,2,1,7,12,5,1,1,0,0,16544,6.8,17779,194,56,-3011,-1199,19.4,1654.4,16,0,0,12,7,20,0,0,0,0,19555,7.0,18978,222,36,3011,1199,22.2,1955.5
4479932808,0,15,3,0,1,3,1,0,0,0,0,13638,6.8,16479,190,59,-2033,-1612,19.0,1363.8,19,3,1,3,1,3,0,0,0,0,15671,7.2,18091,238,47,2033,1612,23.8,1567.1
4527063486,1,28,2,1,7,5,12,0,0,0,0,16674,6.8,17188,204,47,111,-199,20.4,1667.4,23,1,0,5,7,5,2,1,1,0,16563,7.0,17387,221,48,-111,199,22.1,1656.3
4524429073,0,15,0,0,9,7,10,0,0,0,0,17352,6.6,17764,220,45,612,678,22.0,1735.2,16,1,1,7,9,3,1,1,0,0,16740,6.8,17086,223,48,-612,-678,22.3,1674.0
4501993937,1,59,3,1,12,5,19,1,1,0,0,19607,7.6,19804,221,44,3913,2948,22.1,1960.7,17,2,0,5,12,7,0,0,0,0,15694,6.6,16856,220,52,-3913,-2948,22.0,1569.4
4520855918,1,16,3,0,9,3,11,1,1,0,0,17483,7.2,18777,222,44,2186,1698,22.2,1748.3,17,0,1,3,9,3,0,0,0,0,15297,6.8,17079,231,51,-2186,-1698,23.1,1529.7
4519324641,1,34,0,1,13,5,12,1,1,0,0,19535,7.4,19835,231,53,4778,4324,23.1,1953.5,17,2,0,5,13,5,0,0,0,0,14757,6.2,15511,173,51,-4778,-4324,17.3,1475.7
4520976634,0,16,2,1,2,11,2,1,1,0,0,13932,6.4,15660,193,56,-5540,-3682,19.3,1393.2,17,2,0,11,2,13,0,0,0,1,19472,7.2,19342,245,40,5540,3682,24.5,1947.2
4410192659,0,13,1,0,6,8,6,0,0,0,0,15883,6.8,16480,228,28,-791,-2157,22.8,1588.3,17,0,1,8,6,7,0,0,0,0,16674,6.8,18637,213,48,791,2157,21.3,1667.4
4527372782,0,14,4,0,5,3,5,0,0,0,0,15897,7.0,18190,226,44,485,858,22.6,1589.7,15,3,1,3,5,3,0,0,0,0,15412,6.8,17332,238,31,-485,-858,23.8,1541.2
4470743478,0,15,3,1,9,10,9,1,1,0,0,17633,7.0,18304,218,51,-811,-410,21.8,1763.3,23,3,0,10,9,11,0,0,0,0,18444,7.0,18714,230,44,811,410,23.0,1844.4
4490700723,0,18,5,1,3,3,3,0,0,0,0,14907,6.6,16847,205,50,-1021,-2152,20.5,1490.7,17,4,0,3,3,5,1,1,0,0,15928,7.2,18999,238,71,1021,2152,23.8,1592.8
4484008724,1,28,1,1,12,7,13,0,0,0,0,19146,7.4,19236,214,55,2994,2952,21.4,1914.6,11,3,0,7,12,7,1,1,0,0,16152,6.6,16284,175,50,-2994,-2952,17.5,1615.2
4484372363,1,16,5,0,6,10,6,1,1,0,0,15815,6.6,16869,196,43,-1754,-211,19.6,1581.5,18,3,1,10,6,10,0,0,0,0,17569,6.6,17080,201,40,1754,211,20.1,1756.9
4520650822,0,16,3,1,3,3,3,1,1,0,0,15471,7.0,17472,233,56,-390,-502,23.3,1547.1,19,4,0,3,3,5,1,0,1,0,15861,6.8,17974,240,47,390,502,24.0,1586.1
4503795353,1,16,6,0,7,8,7,1,0,1,0,16936,7.0,18077,236,43,-96,827,23.6,1693.6,20,5,1,8,7,8,1,1,0,0,17032,6.8,17250,211,52,96,-827,21.1,1703.2
4511728953,1,15,2,0,4,5,3,1,1,0,0,15859,7.2,18390,242,59,-88,-932,24.2,1585.9,41,2,1,5,4,10,0,0,0,0,15947,7.2,19322,222,61,88,932,22.2,1594.7
4526085370,1,21,5,1,12,6,8,1,1,0,0,18432,7.2,19560,224,41,2495,3183,22.4,1843.2,19,2,0,6,12,8,0,0,0,0,15937,6.8,16377,193,52,-2495,-3183,19.3,1593.7
4525545485,1,14,1,1,9,7,9,0,0,0,0,18880,7.0,19278,235,54,2690,2514,23.5,1888.0,17,2,0,7,9,9,1,1,0,0,16190,6.6,16764,193,43,-2690,-2514,19.3,1619.0
4508717293,0,18,3,1,5,8,3,0,0,0,0,15177,6.6,16094,206,33,-2399,-2317,20.6,1517.7,15,3,0,8,5,7,1,1,0,0,17576,7.0,18411,243,47,2399,2317,24.3,1757.6
4518322002,1,39,2,0,8,9,8,0,0,0,0,17389,7.0,18770,218,43,-1067,-523,21.8,1738.9,18,2,1,9,8,9,1,1,0,0,18456,7.4,19293,234,60,1067,523,23.4,1845.6
4514235759,1,15,0,0,9,8,5,1,0,1,0,17149,6.8,17767,211,35,-417,-1028,21.1,1714.9,39,4,1,8,9,6,1,1,0,0,17566,7.0,18795,215,61,417,1028,21.5,1756.6
4523432190,1,41,1,1,3,7,4,0,0,0,0,15715,7.0,18159,246,54,-1235,-956,24.6,1571.5,17,17,0,7,3,4,1,1,0,0,16950,7.2,19115,252,52,1235,956,25.2,1695.0
4524281018,0,17,3,1,3,2,3,2,1,1,0,15207,7.0,18559,234,54,-211,843,23.4,1520.7,19,4,0,2,3,4,0,0,0,0,15418,7.0,17716,211,48,211,-843,21.1,1541.8
4520888635,1,16,4,1,7,6,7,0,0,0,0,16160,6.8,17319,206,60,-106,-62,20.6,1616.0,57,2,0,6,7,5,0,0,0,0,16266,6.8,17381,229,36,106,62,22.9,1626.6
4510669887,1,39,3,0,1,2,0,1,1,0,0,14645,7.2,18690,256,52,-1377,-180,25.6,1464.5,49,3,1,2,1,2,1,0,1,0,16022,7.2,18870,289,56,1377,180,28.9,1602.2
4511949314,1,5,1,0,4,8,5,0,0,0,0,14834,6.6,16539,191,52,-2714,-427,19.1,1483.4,18,0,1,8,4,11,1,0,1,0,17548,6.8,16966,198,51,2714,427,19.8,1754.8
4495602419,0,12,1,0,7,10,8,0,0,0,0,16575,7.0,18524,204,42,-2362,79,20.4,1657.5,230,1,1,10,7,9,0,0,0,0,18937,7.0,18445,247,44,2362,-79,24.7,1893.7
4473795908,1,16,4,1,7,2,6,0,0,0,1,19456,7.8,21097,230,76,4525,4052,23.0,1945.6,26,0,0,2,7,2,0,0,0,0,14931,6.6,17045,247,52,-4525,-4052,24.7,1493.1
4479492497,1,12,2,1,14,6,10,1,0,1,1,20225,6.6,17976,194,50,4453,2458,19.4,2022.5,17,2,0,6,14,6,1,1,0,0,15772,6.6,15518,189,40,-4453,-2458,18.9,1577.2
4502410789,1,16,3,0,4,4,4,1,1,0,0,16452,7.4,19169,266,60,772,702,26.6,1645.2,39,5,1,4,4,2,0,0,0,0,15680,7.0,18467,215,60,-772,-702,21.5,1568.0
4522843315,1,18,0,1,9,8,7,0,0,0,0,16908,6.8,17271,196,31,-363,-191,19.6,1690.8,40,2,0,8,9,9,1,1,0,0,17271,6.8,17462,187,68,363,191,18.7,1727.1
4487468549,1,15,3,0,12,7,16,0,0,0,0,19246,7.2,19668,231,40,2861,1432,23.1,1924.6,15,2,1,7,12,5,0,0,0,0,16385,6.8,18236,213,55,-2861,-1432,21.3,1638.5
4519672552,0,29,3,0,9,7,10,0,0,0,0,17126,6.8,17604,195,52,1386,679,19.5,1712.6,18,2,1,7,9,4,1,1,0,0,15740,6.6,16925,202,48,-1386,-679,20.2,1574.0
4525139840,1,16,3,1,10,4,13,0,0,0,0,17408,7.2,18740,193,47,2366,1147,19.3,1740.8,14,4,0,4,10,5,1,1,0,0,15042,6.8,17593,231,44,-2366,-1147,23.1,1504.2
4511428769,1,13,0,0,9,6,10,1,0,1,0,17491,7.0,18181,194,74,616,43,19.4,1749.1,15,2,1,6,9,5,1,1,0,0,16875,6.8,18138,253,36,-616,-43,25.3,1687.5
4480194384,0,15,2,1,5,7,4,0,0,0,0,15977,6.8,18136,206,71,-1130,-347,20.6,1597.7,15,2,0,7,5,8,1,1,0,0,17107,7.2,18483,230,56,1130,347,23.0,1710.7
4516959176,0,18,1,0,7,8,9,0,0,0,0,15903,6.8,17263,189,40,-1831,-2604,18.9,1590.3,14,2,1,8,7,11,2,1,1,0,17734,7.2,19867,226,72,1831,2604,22.6,1773.4
4462226806,0,10,0,0,6,8,4,0,0,0,0,15446,6.4,16131,198,47,-1995,-1392,19.8,1544.6,13,0,1,8,6,7,1,1,0,0,17441,7.0,17523,216,44,1995,1392,21.6,1744.1
4477299853,1,18,4,1,3,3,4,0,0,0,0,15332,7.0,17832,229,55,359,-386,22.9,1533.2,39,2,0,3,3,0,1,1,0,0,14973,7.0,18218,242,48,-359,386,24.2,1497.3
4453444549,0,18,2,1,4,5,6,1,1,0,0,15466,6.8,17220,228,48,488,473,22.8,1546.6,17,3,0,5,4,8,0,0,0,0,14978,6.8,16747,182,48,-488,-473,18.2,1497.8
4496972766,0,15,3,0,6,7,8,0,0,0,0,16564,7.0,18202,213,49,-443,-447,21.3,1656.4,14,2,1,7,6,4,0,0,0,0,17007,7.0,18649,216,46,443,447,21.6,1700.7
4462392955,0,15,1,0,7,6,7,0,0,0,0,16726,7.0,18339,217,44,278,-343,21.7,1672.6,42,0,1,6,7,5,1,1,0,0,16448,7.0,18682,206,64,-278,343,20.6,1644.8
4522304761,1,53,4,0,4,6,5,1,0,1,0,15426,7.0,18021,207,59,-2376,-894,20.7,1542.6,38,7,1,6,4,9,1,1,0,0,17802,7.0,18915,227,59,2376,894,22.7,1780.2
4423842693,1,19,5,0,7,6,7,1,0,1,0,17184,6.6,16943,206,43,1835,393,20.6,1718.4,17,1,1,6,7,5,1,1,0,0,15349,6.6,16550,217,47,-1835,-393,21.7,1534.9
4498399527,1,20,2,1,11,5,11,1,0,1,0,18474,7.0,18239,217,43,2680,1517,21.7,1847.4,15,3,0,5,11,4,0,0,0,0,15794,6.4,16722,219,51,-2680,-1517,21.9,1579.4
4440493059,0,38,1,1,5,2,4,2,1,1,0,16517,7.2,19476,246,56,2123,2669,24.6,1651.7,146,14,0,2,5,4,0,0,0,0,14394,6.6,16807,220,45,-2123,-2669,22.0,1439.4
4510799215,1,14,3,1,4,10,7,1,1,0,0,15471,6.4,15785,192,53,-3033,-3775,19.2,1547.1,18,2,0,10,4,13,0,0,0,0,18504,7.4,19560,207,64,3033,3775,20.7,1850.4
4475259574,1,15,3,1,2,3,2,1,1,0,0,14535,6.4,16699,234,35,-988,-1427,23.4,1453.5,16,1,0,3,2,4,1,0,1,0,15523,7.0,18126,241,48,988,1427,24.1,1552.3
4527682051,1,15,3,0,8,7,6,1,1,0,0,17204,7.0,18534,236,42,1072,1587,23.6,1720.4,14,2,1,7,8,7,0,0,0,0,16132,6.6,16947,222,38,-1072,-1587,22.2,1613.2
4523109527,0,91,2,1,3,5,3,0,0,0,0,15001,7.0,17799,218,48,-685,-1871,21.8,1500.1,16,3,0,5,3,2,1,0,1,0,15686,7.2,19670,214,64,685,1871,21.4,1568.6
4523781567,1,10,3,0,5,5,4,0,0,0,0,16368,7.0,18622,250,48,1079,1363,25.0,1636.8,14,3,1,5,5,7,1,1,0,0,15289,7.0,17259,206,56,-1079,-1363,20.6,1528.9
4519205202,1,18,2,0,5,6,7,0,0,0,0,16003,6.6,17152,213,55,-954,-1007,21.3,1600.3,18,4,1,6,5,14,1,1,0,0,16957,7.0,18159,261,49,954,1007,26.1,1695.7
4511485561,1,19,4,1,8,4,13,1,1,0,0,16712,6.8,17797,194,48,2357,1436,19.4,1671.2,54,3,0,4,8,3,0,0,0,0,14355,6.4,16361,162,52,-2357,-1436,16.2,1435.5
4519771711,0,19,2,0,10,8,9,0,0,0,0,18359,6.8,17074,190,48,1462,249,19.0,1835.9,16,3,1,8,10,12,0,0,0,0,16897,6.6,16825,160,47,-1462,-249,16.0,1689.7
4491875550,1,38,1,1,7,5,4,1,1,0,0,16605,7.0,18407,199,61,-643,508,19.9,1660.5,17,3,0,5,7,5,1,0,1,1,17248,6.8,17899,241,46,643,-508,24.1,1724.8
4495207982,1,17,6,1,6,5,3,2,1,1,0,15711,6.8,18516,196,56,458,2243,19.6,1571.1,23,2,0,5,6,4,0,0,0,0,15253,6.6,16273,219,32,-458,-2243,21.9,1525.3
4493760439,1,143,2,1,3,5,3,1,1,0,0,14767,6.8,16754,214,60,-1371,-1951,21.4,1476.7,18,8,0,5,3,4,0,0,0,0,16138,7.0,18705,256,43,1371,1951,25.6,1613.8
4502814468,0,13,1,1,5,6,6,0,0,0,0,16157,7.0,17878,221,51,142,1215,22.1,1615.7,115,2,0,6,5,6,1,1,0,0,16015,6.8,16663,199,41,-142,-1215,19.9,1601.5
4503692429,0,13,2,0,1,9,1,0,0,0,0,13508,6.6,15474,186,50,-5373,-4474,18.6,1350.8,15,4,1,9,1,11,2,1,1,0,18881,7.2,19948,241,49,5373,4474,24.1,1888.1
4519478233,1,15,1,1,9,7,10,2,1,1,0,17208,7.2,18913,201,53,423,1071,20.1,1720.8,12,1,0,7,9,7,0,0,0,0,16785,7.0,17842,222,46,-423,-1071,22.2,1678.5
4483634862,0,14,1,0,5,12,5,0,0,0,0,15634,6.6,16435,222,40,-3194,-2675,22.2,1563.4,50,2,1,12,5,13,1,0,1,0,18828,7.2,19110,205,52,3194,2675,20.5,1882.8
4492487479,0,13,3,0,7,5,7,0,0,0,0,16514,7.2,18198,211,52,1232,1358,21.1,1651.4,14,2,1,5,7,3,1,1,0,0,15282,6.6,16840,215,48,-1232,-1358,21.5,1528.2
4504089407,1,9,1,1,6,6,7,0,0,0,0,17500,7.2,18692,226,56,2077,266,22.6,1750.0,16,2,0,6,6,4,1,1,0,0,15423,6.8,18426,212,47,-2077,-266,21.2,1542.3
4501443265,1,14,2,0,7,9,7,0,0,0,0,17309,6.8,17384,231,46,334,-302,23.1,1730.9,16,1,1,9,7,12,1,1,0,0,16975,7.0,17686,191,52,-334,302,19.1,1697.5
4449152051,1,20,2,0,14,3,16,1,0,1,0,19483,7.2,19290,227,34,5019,3765,22.7,1948.3,16,2,1,3,14,1,0,0,0,0,14464,6.4,15525,203,52,-5019,-3765,20.3,1446.4
4525181648,0,14,1,0,9,5,10,0,0,0,0,17605,7.2,19074,241,40,1132,778,24.1,1760.5,82,3,1,5,9,5,0,0,0,0,16473,7.0,18296,219,59,-1132,-778,21.9,1647.3
4452001720,0,13,4,0,2,13,3,0,0,0,0,12798,5.4,12111,187,4,-8472,-8242,18.7,1279.8,16,1,1,13,2,16,1,1,0,1,21270,7.6,20353,224,64,8472,8242,22.4,2127.0
4471271254,1,14,2,1,8,4,9,0,0,0,0,18051,7.2,19471,247,64,2563,2910,24.7,1805.1,15,1,0,4,8,4,0,0,0,0,15488,6.6,16561,233,40,-2563,-2910,23.3,1548.8
4515286916,0,40,3,1,5,7,7,0,0,0,0,15799,6.4,16589,224,32,-1069,-1901,22.4,1579.9,20,4,0,7,5,5,0,0,0,0,16868,7.0,18490,215,53,1069,1901,21.5,1686.8
4525215598,1,57,3,0,6,9,6,1,1,0,0,15824,6.6,16324,210,41,-2047,-2330,21.0,1582.4,19,3,1,9,6,8,1,0,1,0,17871,6.8,18654,205,64,2047,2330,20.5,1787.1
4477502000,1,60,4,1,6,7,7,1,0,1,0,17247,7.0,18845,233,65,915,1710,23.3,1724.7,16,3,0,7,6,9,0,0,0,0,16332,7.0,17135,214,36,-915,-1710,21.4,1633.2
4517186404,1,16,2,1,10,9,9,1,1,0,0,19219,7.0,18673,229,50,2346,1776,22.9,1921.9,9,0,0,9,10,10,0,0,0,0,16873,6.8,16897,177,35,-2346,-1776,17.7,1687.3
4526830750,1,19,3,0,7,6,12,1,1,0,0,17737,7.0,18873,220,48,1126,549,22.0,1773.7,51,0,1,6,7,10,0,0,0,0,16611,7.2,18324,228,55,-1126,-549,22.8,1661.1
4519466762,0,16,6,0,1,2,1,1,1,0,0,13486,6.6,16382,200,47,-1433,-394,20.0,1348.6,16,2,1,2,1,2,0,0,0,0,14919,6.6,16776,241,40,1433,394,24.1,1491.9
4490472819,0,15,2,1,8,8,5,0,0,0,0,16795,6.8,18159,235,48,-507,-790,23.5,1679.5,17,2,0,8,8,9,1,0,1,0,17302,7.2,18949,203,56,507,790,20.3,1730.2
4514501540,0,15,7,0,7,4,10,1,0,1,0,16008,7.2,18460,210,49,178,1499,21.0,1600.8,18,4,1,4,7,5,0,0,0,0,15830,6.6,16961,227,44,-178,-1499,22.7,1583.0
4515356970,1,18,4,0,8,7,4,0,0,0,0,16935,7.0,18740,210,60,469,1328,21.0,1693.5,17,6,1,7,8,12,0,0,0,0,16466,7.0,17412,212,32,-469,-1328,21.2,1646.6
4520677506,0,16,4,0,5,12,3,0,0,0,0,15140,6.4,15745,198,39,-3371,-2094,19.8,1514.0,19,4,1,12,5,15,1,1,0,0,18511,7.0,17839,217,52,3371,2094,21.7,1851.1
4483620406,0,19,2,0,3,6,1,1,0,1,0,14499,7.0,18406,201,68,-3079,-1816,20.1,1449.9,13,4,1,6,3,4,1,1,0,0,17578,7.2,20222,245,63,3079,1816,24.5,1757.8
4460077928,1,17,4,1,9,8,12,0,0,0,0,18385,7.4,19948,248,65,607,1293,24.8,1838.5,17,5,0,8,9,8,2,1,1,0,17778,7.0,18655,240,56,-607,-1293,24.0,1777.8
4524012656,0,17,2,1,5,8,4,0,0,0,0,16568,7.0,18504,239,51,-1163,-1130,23.9,1656.8,30,5,0,8,5,11,1,1,0,0,17731,7.4,19634,223,72,1163,1130,22.3,1773.1
4524384067,0,43,1,0,4,5,5,1,0,1,0,15157,7.0,17954,201,55,-1321,-7,20.1,1515.7,15,2,1,5,4,10,0,0,0,0,16478,7.0,17961,235,47,1321,7,23.5,1647.8
4509918642,1,17,2,1,10,1,5,0,0,0,1,19699,7.4,20307,251,43,5935,2933,25.1,1969.9,13,1,0,1,10,1,1,1,0,0,13764,7.0,17374,184,70,-5935,-2933,18.4,1376.4
4465222745,1,14,2,0,4,6,9,0,0,0,0,15858,7.0,17780,215,54,-1050,522,21.5,1585.8,13,0,1,6,4,10,0,0,0,0,16908,6.8,17258,213,52,1050,-522,21.3,1690.8
4506115923,1,15,2,1,5,6,4,1,1,0,0,16803,7.0,18053,251,57,1349,924,25.1,1680.3,15,3,0,6,5,6,0,0,0,0,15454,6.8,17129,182,33,-1349,-924,18.2,1545.4
4526558273,0,14,1,1,8,9,6,1,1,0,0,16889,6.6,16862,198,52,-696,-1472,19.8,1688.9,15,1,0,9,8,6,0,0,0,0,17585,7.0,18334,201,54,696,1472,20.1,1758.5
4523672153,0,19,3,1,10,7,10,1,1,0,0,18312,6.8,18057,239,46,1250,-226,23.9,1831.2,17,4,0,7,10,5,1,0,1,0,17062,6.8,18283,206,57,-1250,226,20.6,1706.2
4518030452,0,11,2,1,7,11,11,0,0,0,0,17444,6.4,16497,213,42,-1642,-4442,21.3,1744.4,11,1,0,11,7,16,1,1,0,0,19086,7.6,20939,223,71,1642,4442,22.3,1908.6
4520613359,0,18,2,0,2,2,2,0,0,0,0,15608,6.8,17516,260,47,766,331,26.0,1560.8,37,5,1,2,2,2,0,0,0,0,14842,7.0,17185,229,52,-766,-331,22.9,1484.2
4524697889,0,25,4,1,5,3,4,1,0,1,0,16788,7.2,19474,264,59,1346,919,26.4,1678.8,39,3,0,3,5,6,1,1,0,0,15442,7.2,18555,242,56,-1346,-919,24.2,1544.2
4522664876,0,16,3,1,7,5,7,0,0,0,0,17406,7.0,18922,240,48,1104,183,24.0,1740.6,15,4,0,5,7,8,1,1,0,0,16302,7.2,18739,207,48,-1104,-183,20.7,1630.2
4494295244,1,17,5,0,7,7,8,0,0,0,0,16310,6.8,17712,219,44,464,426,21.9,1631.0,16,2,1,7,7,4,1,1,0,0,15846,6.8,17286,212,48,-464,-426,21.2,1584.6
4490919481,0,58,4,1,3,7,4,1,1,0,0,13957,6.4,16250,187,48,-2788,-1304,18.7,1395.7,15,5,0,7,3,10,0,0,0,0,16745,6.8,17554,210,48,2788,1304,21.0,1674.5
4520495529,1,15,5,1,6,3,5,2,1,1,0,16929,7.4,19425,263,54,1101,1147,26.3,1692.9,80,4,0,3,6,3,0,0,0,0,15828,7.2,18278,242,49,-1101,-1147,24.2,1582.8
4513417068,0,15,1,1,3,6,3,1,1,0,0,15299,6.4,17076,230,52,-874,-1276,23.0,1529.9,39,1,0,6,3,6,0,0,0,0,16173,7.0,18352,231,44,874,1276,23.1,1617.3
4526291828,1,17,0,0,5,2,3,2,1,1,0,17956,7.0,18251,271,50,4594,2745,27.1,1795.6,18,3,1,2,5,6,0,0,0,0,13362,6.4,15506,187,33,-4594,-2745,18.7,1336.2
4518570301,1,17,2,1,2,4,4,1,0,1,0,15565,6.4,17312,251,64,-1185,-2402,25.1,1556.5,21,2,0,4,2,8,1,1,0,0,16750,7.4,19714,267,62,1185,2402,26.7,1675.0
4521364269,1,16,1,1,6,0,5,1,1,0,0,17002,7.2,19584,227,59,4376,4106,22.7,1700.2,18,2,0,0,6,0,0,0,0,0,12626,6.2,15478,184,48,-4376,-4106,18.4,1262.6
4474939096,1,15,4,1,1,0,1,0,0,0,0,14812,6.6,17296,254,53,1221,-311,25.4,1481.2,37,3,0,0,1,0,1,1,0,0,13591,6.8,17607,214,60,-1221,311,21.4,1359.1
4518300534,0,15,0,0,6,6,9,0,0,0,0,16299,6.8,17800,226,42,80,-599,22.6,1629.9,13,2,1,6,6,4,1,1,0,0,16219,7.2,18399,210,48,-80,599,21.0,1621.9
4525380642,0,17,1,0,15,7,13,1,0,1,0,20066,7.2,19018,209,40,4646,3861,20.9,2006.6,18,2,1,7,15,7,0,0,0,0,15420,6.0,15157,193,33,-4646,-3861,19.3,1542.0
4517857557,0,14,2,0,4,5,7,1,1,0,0,15786,6.8,17823,207,54,-92,-1170,20.7,1578.6,15,2,1,5,4,3,0,0,0,0,15878,7.4,18993,215,50,92,1170,21.5,1587.8
4459271455,1,14,4,0,13,6,19,1,0,1,0,20617,7.4,19936,240,56,3183,1321,24.0,2061.7,19,1,1,6,13,7,1,1,0,0,17434,7.0,18615,235,72,-3183,-1321,23.5,1743.4
4512161240,1,17,5,1,8,7,4,1,0,1,0,17505,7.2,19027,236,48,1014,850,23.6,1750.5,18,2,0,7,8,5,1,1,0,0,16491,7.0,18177,201,60,-1014,-850,20.1,1649.1
4470980027,1,24,3,0,12,8,17,1,1,0,0,18360,6.8,17412,202,39,525,476,20.2,1836.0,18,1,1,8,12,7,0,0,0,0,17835,6.6,16936,218,38,-525,-476,21.8,1783.5
4451815027,0,13,5,0,5,4,8,0,0,0,0,16059,7.0,18553,216,48,-1694,-1,21.6,1605.9,22,6,1,4,5,5,2,1,1,1,17753,7.2,18554,231,52,1694,1,23.1,1775.3
4479856862,1,19,5,1,7,7,8,1,1,0,0,16282,6.8,16565,211,44,686,-89,21.1,1628.2,55,3,0,7,7,6,1,0,1,0,15596,6.6,16654,180,51,-686,89,18.0,1559.6
4524348697,0,19,1,0,6,5,3,1,0,1,0,16141,7.4,19201,215,58,488,2349,21.5,1614.1,16,3,1,5,6,9,1,1,0,0,15653,6.6,16852,183,44,-488,-2349,18.3,1565.3
4524995647,1,18,4,1,9,4,6,2,1,1,0,18200,7.2,19696,247,44,2756,2028,24.7,1820.0,16,3,0,4,9,5,0,0,0,0,15444,7.0,17668,208,51,-2756,-2028,20.8,1544.4
4454239214,0,16,4,0,3,10,2,0,0,0,0,14032,6.8,16550,193,40,-4782,-3408,19.3,1403.2,17,8,1,10,3,11,1,1,0,0,18814,7.4,19958,245,51,4782,3408,24.5,1881.4
4522798841,0,17,3,1,12,10,18,1,1,0,0,17974,6.2,15423,182,34,186,-741,18.2,1797.4,14,3,0,10,12,9,1,0,1,0,17788,6.4,16164,188,40,-186,741,18.8,1778.8
4517783802,0,12,0,1,3,11,5,0,0,0,0,14145,6.0,15252,186,40,-5471,-4481,18.6,1414.5,11,1,0,11,3,10,2,1,1,1,19616,7.6,19733,228,57,5471,4481,22.8,1961.6
4452219290,1,52,6,1,5,1,9,1,1,0,0,16809,7.2,18916,241,55,2192,464,24.1,1680.9,16,4,0,1,5,1,0,0,0,0,14617,6.8,18452,246,59,-2192,-464,24.6,1461.7
4526563599,0,12,1,1,2,8,0,0,0,0,0,14021,6.2,15684,200,55,-3792,-3472,20.0,1402.1,17,2,0,8,2,8,1,1,0,0,17813,7.2,19156,236,43,3792,3472,23.6,1781.3
4513777315,0,17,3,1,10,7,11,1,1,0,0,18454,7.2,19370,230,53,1455,602,23.0,1845.4,19,4,0,7,10,5,0,0,0,0,16999,7.0,18768,247,48,-1455,-602,24.7,1699.9
4525623661,1,13,2,1,4,1,1,1,1,0,0,16070,7.0,18706,251,56,2422,1766,25.1,1607.0,13,1,0,1,4,3,0,0,0,0,13648,6.6,16940,199,52,-2422,-1766,19.9,1364.8
4504146901,0,14,2,0,2,5,3,0,0,0,0,15128,7.0,17938,251,53,-860,-334,25.1,1512.8,17,2,1,5,2,9,1,1,0,0,15988,7.0,18272,226,52,860,334,22.6,1598.8
4493167660,0,86,5,0,3,7,3,0,0,0,0,14454,6.6,17394,191,46,-3003,-2118,19.1,1445.4,17,2,1,7,3,5,1,1,0,0,17457,7.4,19512,239,56,3003,2118,23.9,1745.7
4520510756,0,18,2,0,6,5,6,0,0,0,0,15566,6.8,17340,211,52,-1951,-872,21.1,1556.6,12,4,1,5,6,6,1,1,0,0,17517,7.2,18212,233,68,1951,872,23.3,1751.7
4489107680,0,17,3,1,8,7,9,0,0,0,0,17164,7.0,18932,222,55,525,902,22.2,1716.4,17,0,0,7,8,7,0,0,0,0,16639,6.8,18030,215,55,-525,-902,21.5,1663.9
4519124601,0,17,3,1,4,4,3,1,1,0,0,15842,7.0,18640,240,60,71,409,24.0,1584.2,17,5,0,4,4,6,0,0,0,0,15771,7.0,18231,227,48,-71,-409,22.7,1577.1
4500809848,0,16,3,0,3,6,1,0,0,0,0,15533,6.8,18287,244,66,-1585,-280,24.4,1553.3,19,2,1,6,3,10,1,1,0,0,17118,7.0,18567,256,60,1585,280,25.6,1711.8
4525540898,1,15,1,1,6,3,7,1,0,1,0,16421,6.4,16972,207,52,936,-497,20.7,1642.1,38,4,0,3,6,3,1,1,0,0,15485,7.2,17469,231,60,-936,497,23.1,1548.5
4469857979,0,13,2,0,3,7,5,0,0,0,0,15423,7.2,18610,241,52,-2523,-732,24.1,1542.3,13,4,1,7,3,7,1,1,0,0,17946,7.4,19342,248,48,2523,732,24.8,1794.6
4511755420,1,15,2,0,3,4,4,0,0,0,0,14205,6.6,16546,203,40,-1115,178,20.3,1420.5,18,2,1,4,3,4,1,1,0,0,15320,6.6,16368,192,52,1115,-178,19.2,1532.0
4512610035,0,14,3,0,4,9,3,1,1,0,0,15533,7.0,18431,214,56,-3728,-2079,21.4,1553.3,16,4,1,9,4,8,0,0,0,0,19261,7.4,20510,259,65,3728,2079,25.9,1926.1
4481697328,0,20,5,1,9,4,2,2,1,1,0,16730,7.0,19072,198,68,178,424,19.8,1673.0,22,9,0,4,9,3,0,0,0,0,16552,7.2,18648,245,56,-178,-424,24.5,1655.2
4499816860,0,26,3,1,4,5,4,1,1,0,0,15273,6.8,17539,211,60,-808,-311,21.1,1527.3,20,1,0,5,4,6,0,0,0,0,16081,7.2,17850,238,45,808,311,23.8,1608.1
4522327087,0,18,3,0,5,8,5,0,0,0,0,16007,7.2,18083,207,56,-1534,-167,20.7,1600.7,70,3,1,8,5,9,2,1,1,0,17541,6.8,18250,196,64,1534,167,19.6,1754.1
4507906243,1,17,3,1,6,5,6,0,0,0,0,16793,7.0,19426,233,62,463,275,23.3,1679.3,16,4,0,5,6,7,1,1,0,0,16330,7.4,19151,224,62,-463,-275,22.4,1633.0
4505404755,1,13,1,0,4,4,5,1,1,0,0,15398,6.8,17802,200,60,-893,771,20.0,1539.8,15,2,1,4,4,4,0,0,0,1,16291,6.8,17031,212,36,893,-771,21.2,1629.1
4522675513,1,19,6,1,4,3,2,1,1,0,0,15834,7.0,19029,258,48,782,1642,25.8,1583.4,19,5,0,3,4,3,0,0,0,0,15052,6.6,17387,238,40,-782,-1642,23.8,1505.2
4495401600,1,16,1,1,2,4,2,1,1,0,0,14402,7.0,17604,193,64,-1506,-500,19.3,1440.2,15,2,0,4,2,6,0,0,0,0,15908,6.8,18104,227,52,1506,500,22.7,1590.8
4441973762,1,15,3,1,13,9,13,1,1,0,1,21908,7.4,20909,227,84,4612,2877,22.7,2190.8,15,1,0,9,13,12,0,0,0,0,17296,7.0,18032,195,44,-4612,-2877,19.5,1729.6
4497909017,0,17,5,1,7,8,2,0,0,0,0,15684,6.6,17100,203,47,-1400,-644,20.3,1568.4,21,5,0,8,7,10,1,1,0,0,17084,7.0,17744,208,40,1400,644,20.8,1708.4
4487676643,1,15,2,1,6,4,4,0,0,0,0,16792,7.2,18901,238,52,1852,2113,23.8,1679.2,20,1,0,4,6,5,0,0,0,0,14940,6.6,16788,218,40,-1852,-2113,21.8,1494.0
4429490822,1,17,4,0,11,9,12,1,1,0,0,18585,7.2,19498,221,55,1139,1170,22.1,1858.5,14,0,1,9,11,9,0,0,0,0,17446,7.0,18328,218,54,-1139,-1170,21.8,1744.6
4518426899,0,14,2,0,5,7,5,0,0,0,0,16565,7.0,17659,220,48,-245,-1208,22.0,1656.5,15,1,1,7,5,3,0,0,0,0,16810,7.0,18867,244,51,245,1208,24.4,1681.0
4481415061,0,10,1,0,6,14,3,0,0,0,0,16142,6.8,16953,198,59,-3109,-1745,19.8,1614.2,13,1,1,14,6,16,2,1,1,0,19251,7.0,18698,201,37,3109,1745,20.1,1925.1
4500687748,0,16,6,0,3,4,2,1,0,1,0,15527,6.8,18231,223,48,-564,-298,22.3,1552.7,19,4,1,4,3,7,1,1,0,0,16091,7.0,18529,246,67,564,298,24.6,1609.1
4517744860,1,20,2,1,7,7,7,1,1,0,0,16636,6.8,17569,207,53,-1117,-509,20.7,1663.6,16,4,0,7,7,4,0,0,0,0,17753,7.0,18078,230,54,1117,509,23.0,1775.3
4525839083,1,35,3,1,10,5,9,2,1,1,1,19439,7.4,19736,244,50,3863,2639,24.4,1943.9,17,2,0,5,10,5,0,0,0,0,15576,6.6,17097,197,49,-3863,-2639,19.7,1557.6
4519269898,1,16,1,1,6,8,5,0,0,0,0,15969,6.8,17938,231,40,-809,10,23.1,1596.9,10,2,0,8,6,8,0,0,0,0,16778,6.6,17928,216,35,809,-10,21.6,1677.8
4464918638,0,123,2,1,5,7,6,0,0,0,0,16560,7.2,19116,235,57,-529,-54,23.5,1656.0,65,1,0,7,5,8,1,1,0,0,17089,7.0,19170,223,63,529,54,22.3,1708.9
4475394181,0,18,2,1,6,5,2,1,1,0,0,15531,7.0,17915,192,52,-537,176,19.2,1553.1,20,3,0,5,6,5,0,0,0,0,16068,6.8,17739,198,64,537,-176,19.8,1606.8
4474674368,0,19,2,0,6,5,7,1,1,0,0,15529,7.0,17721,204,39,-413,-1004,20.4,1552.9,13,3,1,5,6,2,1,0,1,0,15942,7.0,18725,237,48,413,1004,23.7,1594.2
4521837052,1,19,1,0,5,9,7,0,0,0,0,15701,6.8,16610,186,60,-2760,-2274,18.6,1570.1,16,2,1,9,5,9,1,1,0,0,18461,7.2,18884,247,50,2760,2274,24.7,1846.1
4486227010,1,12,3,0,6,6,3,0,0,0,0,16072,7.0,18312,229,40,-346,316,22.9,1607.2,15,1,1,6,6,6,1,1,0,0,16418,6.8,17996,241,43,346,-316,24.1,1641.8
4525024400,0,15,23,0,8,13,12,0,0,0,0,16342,6.6,16909,165,42,-5219,-3480,16.5,1634.2,41,2,1,13,8,15,0,0,0,1,21561,7.4,20389,263,40,5219,3480,26.3,2156.1
4522846190,0,16,4,0,3,5,3,0,0,0,0,15404,7.0,17893,244,52,-1793,-1226,24.4,1540.4,17,2,1,5,3,7,1,1,0,0,17197,7.0,19119,254,68,1793,1226,25.4,1719.7
4525810853,1,17,1,1,6,1,7,0,0,0,0,16561,7.4,19634,226,63,1852,2435,22.6,1656.1,16,2,0,1,6,2,1,1,0,0,14709,7.0,17199,238,60,-1852,-2435,23.8,1470.9
4525210320,0,37,3,1,6,3,9,1,1,0,0,16989,7.0,18073,242,48,1359,132,24.2,1698.9,38,18,0,3,6,2,0,0,0,0,15630,7.0,17941,239,60,-1359,-132,23.9,1563.0
4492820318,1,51,3,0,10,5,16,1,1,0,1,17535,6.4,15420,173,40,1436,-1544,17.3,1753.5,14,2,1,5,10,4,0,0,0,0,16099,6.8,16964,207,66,-1436,1544,20.7,1609.9
4467316184,1,13,0,0,7,6,4,1,1,0,1,17742,7.0,18795,203,64,2294,2616,20.3,1774.2,13,1,1,6,7,6,0,0,0,0,15448,6.6,16179,186,40,-2294,-2616,18.6,1544.8
4525070748,0,19,2,1,9,3,8,0,0,0,0,17049,6.8,17241,202,41,1863,328,20.2,1704.9,17,2,0,3,9,5,0,0,0,0,15186,6.8,16913,204,58,-1863,-328,20.4,1518.6
4526099071,1,16,3,0,7,5,8,0,0,0,0,16905,6.8,17224,214,40,831,8,21.4,1690.5,15,1,1,5,7,8,1,1,0,0,16074,6.8,17216,218,61,-831,-8,21.8,1607.4
4523591734,1,37,3,0,5,9,5,0,0,0,0,15440,6.4,15725,180,43,-1729,118,18.0,1544.0,17,2,1,9,5,8,0,0,0,0,17169,6.4,15607,185,44,1729,-118,18.5,1716.9
4469208357,1,72,1,0,9,9,5,0,0,0,0,17999,7.2,19369,227,43,1128,1720,22.7,1799.9,14,3,1,9,9,12,1,1,0,0,16871,7.0,17649,212,40,-1128,-1720,21.2,1687.1
4521616991,1,23,3,1,5,1,6,1,1,0,0,17196,7.2,19002,239,64,2973,1440,23.9,1719.6,17,7,0,1,5,2,0,0,0,0,14223,6.8,17562,239,48,-2973,-1440,23.9,1422.3
4515734376,0,12,0,1,3,8,3,0,0,0,0,15206,6.8,17404,205,59,-1711,-1201,20.5,1520.6,20,3,0,8,3,11,1,1,0,0,16917,7.0,18605,217,43,1711,1201,21.7,1691.7
4518346455,1,13,3,1,6,2,9,0,0,0,0,16803,7.4,19509,242,44,1829,1496,24.2,1680.3,15,1,0,2,6,2,1,1,0,0,14974,7.0,18013,239,48,-1829,-1496,23.9,1497.4
4494125131,1,13,1,1,1,4,0,1,1,0,0,14894,6.6,16548,244,44,-2094,-2508,24.4,1489.4,12,1,0,4,1,7,0,0,0,0,16988,7.0,19056,230,66,2094,2508,23.0,1698.8
4519161912,0,17,1,0,6,11,9,0,0,0,0,15536,6.4,15213,179,31,-4562,-3519,17.9,1553.6,20,5,1,11,6,14,2,1,1,1,20098,7.2,18732,226,51,4562,3519,22.6,2009.8
4523082627,0,16,3,1,5,4,4,0,0,0,1,17305,7.2,18581,246,40,2319,135,24.6,1730.5,15,2,0,4,5,2,1,1,0,0,14986,7.0,18446,217,59,-2319,-135,21.7,1498.6
4505605320,1,15,4,1,10,4,13,1,1,0,0,17917,7.2,18904,212,37,3058,1325,21.2,1791.7,37,1,0,4,10,2,1,0,1,0,14859,6.8,17579,222,52,-3058,-1325,22.2,1485.9
4498809510,1,46,1,0,1,8,0,1,0,1,0,14206,7.0,17314,218,64,-2855,-1603,21.8,1420.6,16,14,1,8,1,8,1,1,0,0,17061,7.0,18917,228,56,2855,1603,22.8,1706.1
4505729756,0,15,1,0,7,9,6,0,0,0,0,17550,7.2,18791,237,52,175,989,23.7,1755.0,12,3,1,9,7,9,1,1,0,0,17375,6.8,17802,221,48,-175,-989,22.1,1737.5
4435131804,1,17,6,1,9,2,10,0,0,0,0,17922,7.2,18511,224,37,3703,3118,22.4,1792.2,17,4,0,2,9,4,0,0,0,0,14219,6.2,15393,206,40,-3703,-3118,20.6,1421.9
4524090743,0,14,4,0,4,8,3,1,0,1,0,15484,7.2,18316,226,50,-2528,-882,22.6,1548.4,42,1,1,8,4,11,1,1,0,0,18012,7.2,19198,236,56,2528,882,23.6,1801.2
4507361840,1,13,2,1,5,0,4,1,1,0,0,16184,7.0,18007,223,51,2813,1222,22.3,1618.4,10,1,0,0,5,0,0,0,0,0,13371,6.6,16785,210,48,-2813,-1222,21.0,1337.1
4490390200,1,13,3,0,7,5,2,1,1,0,0,17247,7.2,19189,249,63,2152,2575,24.9,1724.7,17,2,1,5,7,7,0,0,0,0,15095,6.8,16614,178,40,-2152,-2575,17.8,1509.5
4518392490,1,17,3,0,9,7,9,1,1,0,0,19034,7.4,19369,240,43,4051,3552,24.0,1903.4,15,1,1,7,9,6,0,0,0,0,14983,6.6,15817,178,28,-4051,-3552,17.8,1498.3
4510083368,0,15,1,0,6,13,5,0,0,0,0,16345,6.8,17662,209,42,-2154,-2348,20.9,1634.5,15,1,1,13,6,13,0,0,0,0,18499,7.4,20010,225,36,2154,2348,22.5,1849.9
4525224342,1,13,2,1,3,1,4,0,0,0,0,16372,7.2,18954,279,58,2590,1325,27.9,1637.2,19,4,0,1,3,0,1,1,0,0,13782,7.0,17629,226,53,-2590,-1325,22.6,1378.2
4475799088,0,20,0,0,8,12,9,0,0,0,0,16830,7.0,17100,206,59,-1619,265,20.6,1683.0,21,4,1,12,8,19,1,0,1,0,18449,7.0,16835,158,45,1619,-265,15.8,1844.9
4518072555,0,16,5,0,8,5,10,1,1,0,0,17513,7.0,18498,234,44,834,861,23.4,1751.3,26,1,1,5,8,7,0,0,0,0,16679,6.8,17637,215,60,-834,-861,21.5,1667.9
4518592520,1,14,2,1,7,1,4,1,1,0,0,16614,7.0,18570,221,50,3295,3468,22.1,1661.4,14,2,0,1,7,0,0,0,0,0,13319,6.4,15102,205,50,-3295,-3468,20.5,1331.9
4518710566,0,12,4,0,5,5,10,0,0,0,0,15748,7.0,17980,203,52,-326,833,20.3,1574.8,89,4,1,5,5,5,2,1,1,0,16074,6.6,17147,204,54,326,-833,20.4,1607.4
4492858161,1,19,3,1,13,2,10,0,0,0,1,20998,7.2,19521,228,53,8347,5234,22.8,2099.8,16,1,0,2,13,0,0,0,0,0,12651,5.8,14287,181,35,-8347,-5234,18.1,1265.1
4507950009,0,17,3,0,4,7,4,1,0,1,0,15293,6.8,17145,192,64,-1809,-1431,19.2,1529.3,41,2,1,7,4,11,1,1,0,0,17102,7.0,18576,215,52,1809,1431,21.5,1710.2
4521437370,0,16,1,1,2,5,1,0,0,0,0,14819,7.0,17986,223,63,-930,-594,22.3,1481.9,18,2,0,5,2,3,2,1,1,0,15749,6.8,18580,210,52,930,594,21.0,1574.9
4515559203,1,15,2,1,3,1,3,0,0,0,0,16981,7.2,20082,269,64,1775,1652,26.9,1698.1,60,3,0,1,3,2,2,1,1,0,15206,7.0,18430,256,72,-1775,-1652,25.6,1520.6
4515740615,1,26,4,0,7,8,6,0,0,0,0,17009,7.2,19047,241,43,45,1199,24.1,1700.9,22,1,1,8,7,9,0,0,0,0,16964,7.0,17848,211,36,-45,-1199,21.1,1696.4
4486642684,0,16,4,0,3,3,3,0,0,0,0,15275,6.8,17812,217,56,-701,346,21.7,1527.5,12,1,1,3,3,5,1,1,0,0,15976,6.8,17466,214,56,701,-346,21.4,1597.6
4523021223,0,20,1,0,4,6,2,1,0,1,0,15360,6.6,16644,220,44,-829,-1232,22.0,1536.0,19,2,1,6,4,4,1,1,0,0,16189,6.8,17876,232,43,829,1232,23.2,1618.9
4526244595,0,18,3,1,6,7,6,0,0,0,0,15786,6.8,16824,193,34,-1818,-2061,19.3,1578.6,19,2,0,7,6,4,1,1,0,0,17604,7.2,18885,246,61,1818,2061,24.6,1760.4
4526469771,1,45,4,1,14,5,22,0,0,0,0,19551,7.2,18331,198,43,2896,2001,19.8,1955.1,13,5,0,5,14,6,0,0,0,0,16655,6.6,16330,228,35,-2896,-2001,22.8,1665.5
4511080723,0,55,4,0,1,14,1,1,1,0,0,12747,6.0,14396,180,39,-6435,-5116,18.0,1274.7,15,1,1,14,1,10,0,0,0,0,19182,7.4,19512,227,57,6435,5116,22.7,1918.2
4500949435,0,17,5,0,4,6,8,1,0,1,0,15922,7.0,17677,245,59,-1185,-1150,24.5,1592.2,17,4,1,6,4,7,1,1,0,0,17107,7.2,18827,236,48,1185,1150,23.6,1710.7
4477708439,1,48,0,0,4,5,6,1,1,0,0,15969,7.0,18868,195,72,-876,389,19.5,1596.9,13,2,1,5,4,9,0,0,0,0,16845,7.0,18479,228,63,876,-389,22.8,1684.5
4497646663,0,80,4,0,2,9,1,0,0,0,0,13867,6.2,15515,206,31,-3975,-4232,20.6,1386.7,17,3,1,9,2,9,0,0,0,0,17842,7.0,19747,237,44,3975,4232,23.7,1784.2
4506217760,1,14,3,1,11,6,14,1,1,0,0,18056,6.8,17829,195,54,250,287,19.5,1805.6,268,2,0,6,11,7,1,0,1,1,17806,7.0,17542,210,59,-250,-287,21.0,1780.6
4500173548,1,18,3,1,7,8,9,1,0,1,0,16276,7.0,17562,195,40,-1216,-629,19.5,1627.6,16,3,0,8,7,10,0,0,0,0,17492,7.0,18191,210,76,1216,629,21.0,1749.2
4512968570,1,18,5,1,4,2,5,1,1,0,0,15704,6.8,18292,236,58,1012,519,23.6,1570.4,18,6,0,2,4,0,0,0,0,0,14692,7.0,17773,234,63,-1012,-519,23.4,1469.2
4496563536,1,34,3,0,8,8,9,0,0,0,0,16692,7.0,17643,181,68,-795,-117,18.1,1669.2,35,1,1,8,8,14,0,0,0,0,17487,7.0,17760,222,32,795,117,22.2,1748.7
4503653541,0,20,0,1,6,5,5,0,0,0,0,15428,6.8,16724,201,46,-491,-1417,20.1,1542.8,35,5,0,5,6,4,1,1,0,0,15919,6.8,18141,211,62,491,1417,21.1,1591.9
4521611632,1,10,1,1,7,6,11,2,1,1,0,17410,7.2,18496,239,62,1590,971,23.9,1741.0,12,0,0,6,7,8,0,0,0,0,15820,7.0,17525,216,46,-1590,-971,21.6,1582.0
4516132532,1,14,1,1,5,2,3,0,0,0,0,16568,7.0,18389,222,52,2150,475,22.2,1656.8,11,2,0,2,5,4,1,1,0,0,14418,7.0,17914,228,48,-2150,-475,22.8,1441.8
4526662681,0,15,5,0,12,10,22,0,0,0,0,19390,7.2,18011,200,40,993,425,20.0,1939.0,20,4,1,10,12,12,0,0,0,0,18397,7.0,17586,190,36,-993,-425,19.0,1839.7
4496572605,0,20,6,1,6,4,11,0,0,0,0,16527,7.0,17257,225,44,1338,-385,22.5,1652.7,41,3,0,4,6,7,0,0,0,0,15189,7.0,17642,191,52,-1338,385,19.1,1518.9
4426518452,1,27,7,0,5,4,4,1,1,0,0,15712,6.8,17969,221,46,-169,282,22.1,1571.2,23,4,1,4,5,4,0,0,0,0,15881,6.8,17687,235,50,169,-282,23.5,1588.1
4419367000,1,41,3,0,4,17,4,0,0,0,0,15488,6.6,16539,184,47,-4903,-3146,18.4,1548.8,23,6,1,17,4,16,1,1,0,0,20391,7.4,19685,204,48,4903,3146,20.4,2039.1
4521342021,0,109,2,0,0,5,0,0,0,0,0,13557,6.6,16944,213,60,-2637,-1878,21.3,1355.7,36,6,1,5,0,8,1,1,0,0,16194,6.8,18822,248,52,2637,1878,24.8,1619.4
4522886351,1,19,2,0,6,10,6,0,0,0,0,16093,6.4,16579,181,34,-1908,-1654,18.1,1609.3,11,4,1,10,6,9,1,0,1,0,18001,7.0,18233,220,60,1908,1654,22.0,1800.1
4524952056,0,87,1,0,4,15,4,0,0,0,0,14720,6.2,15031,183,30,-4440,-4020,18.3,1472.0,10,1,1,15,4,14,0,0,0,0,19160,7.4,19051,201,51,4440,4020,20.1,1916.0
4518792896,0,13,1,1,7,8,6,0,0,0,0,15312,6.4,15636,167,45,-1352,-1180,16.7,1531.2,19,6,0,8,7,7,1,1,0,0,16664,6.4,16816,220,41,1352,1180,22.0,1666.4
4503402454,0,18,3,1,11,8,15,0,0,0,0,18923,7.0,18843,225,68,1744,454,22.5,1892.3,16,2,0,8,11,7,1,0,1,0,17179,7.0,18389,219,48,-1744,-454,21.9,1717.9
4523619832,0,15,2,0,7,6,4,1,1,0,0,16519,7.0,18850,203,64,-1464,331,20.3,1651.9,21,2,1,6,7,4,0,0,0,0,17983,7.0,18519,240,60,1464,-331,24.0,1798.3
4525829956,0,15,4,1,2,7,1,1,1,0,0,14324,6.6,16757,211,49,-2638,-1671,21.1,1432.4,16,1,0,7,2,6,0,0,0,0,16962,6.8,18428,244,42,2638,1671,24.4,1696.2
4519807061,1,18,3,0,12,4,16,1,1,0,0,19726,7.4,19180,246,48,5020,3785,24.6,1972.6,13,2,1,4,12,6,0,0,0,0,14706,6.4,15395,192,48,-5020,-3785,19.2,1470.6
4512970043,0,40,2,0,1,5,2,0,0,0,0,13951,7.0,17688,211,49,-2847,-318,21.1,1395.1,13,10,1,5,1,7,1,1,0,0,16798,7.2,18006,239,56,2847,318,23.9,1679.8
4499668279,0,18,1,0,8,5,7,1,1,0,0,16860,7.2,18713,198,71,-147,21,19.8,1686.0,14,1,1,5,8,5,0,0,0,0,17007,7.2,18692,257,56,147,-21,25.7,1700.7
4496990681,0,16,6,0,4,5,7,1,1,0,0,15376,6.6,16496,225,40,-733,-784,22.5,1537.6,15,1,1,5,4,6,0,0,0,0,16109,6.6,17280,201,52,733,784,20.1,1610.9
4522772001,0,14,2,0,4,6,1,0,0,0,0,15310,7.0,18337,221,52,-1038,-1307,22.1,1531.0,15,2,1,6,4,5,2,1,1,0,16348,7.2,19644,226,66,1038,1307,22.6,1634.8
4518559997,0,17,0,1,4,5,3,2,1,1,0,16018,7.2,18223,215,68,-599,192,21.5,1601.8,17,5,0,5,4,10,0,0,0,0,16617,6.8,18031,242,48,599,-192,24.2,1661.7
4509007045,1,23,4,1,8,9,9,1,0,1,0,17610,6.8,17779,212,52,-1168,-674,21.2,1761.0,55,2,0,9,8,17,1,1,0,0,18778,7.2,18453,229,54,1168,674,22.9,1877.8
4503269239,1,21,4,1,10,3,12,2,1,1,0,18557,7.2,19603,235,47,3848,2704,23.5,1855.7,16,4,0,3,10,3,0,0,0,0,14709,6.6,16899,200,40,-3848,-2704,20.0,1470.9
4437927077,0,198,1,1,6,9,6,0,0,0,0,16585,7.0,18342,231,55,-991,-844,23.1,1658.5,12,1,0,9,6,7,0,0,0,0,17576,7.4,19186,223,40,991,844,22.3,1757.6
4462628331,1,13,6,1,7,11,8,0,0,0,0,16749,6.8,17223,226,47,-2320,-1204,22.6,1674.9,37,2,0,11,7,12,2,1,1,0,19069,6.8,18427,207,60,2320,1204,20.7,1906.9
4518093474,0,17,3,1,8,9,7,1,1,0,0,16527,6.6,16884,194,52,-233,-754,19.4,1652.7,39,6,0,9,8,12,1,0,1,0,16760,6.8,17638,197,38,233,754,19.7,1676.0
4524495637,0,35,3,0,9,5,14,0,0,0,0,16563,6.8,17202,182,56,-1292,-1426,18.2,1656.3,13,1,1,5,9,3,2,1,1,1,17855,7.0,18628,237,57,1292,1426,23.7,1785.5
4521355308,1,17,4,0,3,4,1,1,1,0,0,14507,6.6,17455,207,69,-885,180,20.7,1450.7,17,4,1,4,3,4,0,0,0,0,15392,6.8,17275,206,51,885,-180,20.6,1539.2
4512257962,0,40,2,1,7,6,8,2,1,1,0,17002,7.2,18865,209,64,-365,-267,20.9,1700.2,13,2,0,6,7,5,0,0,0,0,17367,7.4,19132,229,50,365,267,22.9,1736.7
4520599588,0,34,0,0,8,10,15,1,1,0,0,17134,6.8,17579,171,66,-840,949,17.1,1713.4,14,3,1,10,8,11,0,0,0,0,17974,6.8,16630,214,49,840,-949,21.4,1797.4
4526195256,1,16,5,1,5,4,5,1,0,1,0,15916,6.8,17531,237,51,73,-806,23.7,1591.6,21,6,0,4,5,4,1,1,0,0,15843,7.0,18337,238,61,-73,806,23.8,1584.3
4523618632,1,15,5,1,6,3,11,1,1,0,0,16389,7.0,17937,241,36,817,-94,24.1,1638.9,38,2,0,3,6,3,0,0,0,0,15572,6.8,18031,229,58,-817,94,22.9,1557.2
4517041040,0,16,3,1,1,7,1,0,0,0,0,13886,6.6,15720,222,36,-3413,-3079,22.2,1388.6,18,3,0,7,1,3,1,1,0,0,17299,7.2,18799,245,46,3413,3079,24.5,1729.9
4518160396,1,12,3,1,3,5,4,1,1,0,0,14323,6.6,16834,184,55,-2546,-2542,18.4,1432.3,14,3,0,5,3,5,1,0,1,0,16869,7.6,19376,243,70,2546,2542,24.3,1686.9
4506503377,1,13,4,1,8,9,8,1,1,0,0,17800,7.2,19759,223,72,-95,194,22.3,1780.0,12,3,0,9,8,9,0,0,0,0,17895,7.0,19565,232,52,95,-194,23.2,1789.5
4459553176,0,19,2,0,8,8,9,1,1,0,0,16352,6.8,17749,214,36,-730,58,21.4,1635.2,11,6,1,8,8,10,0,0,0,0,17082,7.0,17691,191,50,730,-58,19.1,1708.2
4447981243,0,18,3,1,2,13,2,1,1,0,0,14368,6.8,16711,201,52,-5683,-5256,20.1,1436.8,19,5,0,13,2,13,0,0,0,0,20051,8.0,21967,270,49,5683,5256,27.0,2005.1
4489994401,1,14,9,0,11,6,12,1,0,1,0,17850,7.4,18858,204,64,1926,3729,20.4,1785.0,17,0,1,6,11,8,1,1,0,0,15924,6.4,15129,167,39,-1926,-3729,16.7,1592.4
4513287361,1,17,1,1,4,3,5,0,0,0,0,15720,7.0,18012,224,50,1146,1440,22.4,1572.0,15,2,0,3,4,3,1,1,0,0,14574,6.8,16572,211,53,-1146,-1440,21.1,1457.4
4453038156,0,33,2,1,11,11,7,1,0,1,0,16695,7.0,18507,157,40,-1505,-635,15.7,1669.5,17,1,0,11,11,9,0,0,0,0,18200,7.0,19142,188,52,1505,635,18.8,1820.0
4462715361,1,14,7,1,3,5,2,1,0,1,0,15929,7.2,18680,250,51,17,44,25.0,1592.9,35,2,0,5,3,3,1,1,0,0,15912,7.0,18636,203,76,-17,-44,20.3,1591.2
4524232031,1,36,2,1,6,10,6,1,1,0,0,15385,6.6,16039,210,48,-3134,-2772,21.0,1538.5,17,2,0,10,6,8,0,0,0,0,18519,7.0,18811,232,47,3134,2772,23.2,1851.9
4525199033,1,40,2,1,13,6,14,0,0,0,0,18676,7.0,18018,196,44,3188,2289,19.6,1867.6,13,5,0,6,13,5,0,0,0,0,15488,6.4,15729,164,28,-3188,-2289,16.4,1548.8
4515935955,1,19,4,0,7,4,3,2,1,1,0,16700,7.0,19019,218,72,1039,1629,21.8,1670.0,14,3,1,4,7,3,0,0,0,0,15661,7.0,17390,248,48,-1039,-1629,24.8,1566.1
4522518201,0,9,5,1,8,1,5,0,0,0,0,17761,7.4,20143,247,48,2501,2298,24.7,1776.1,18,2,0,1,8,1,0,0,0,0,15260,6.6,17845,251,56,-2501,-2298,25.1,1526.0
4497851268,1,21,3,1,10,5,14,1,1,0,0,18459,7.0,17936,187,52,2955,1124,18.7,1845.9,40,3,0,5,10,7,0,0,0,0,15504,6.8,16812,196,36,-2955,-1124,19.6,1550.4
4520952711,0,21,2,0,4,10,4,0,0,0,0,14135,6.4,15854,182,48,-4416,-3186,18.2,1413.5,16,4,1,10,4,10,1,1,0,0,18551,7.4,19040,231,44,4416,3186,23.1,1855.1
4497280145,0,13,4,1,5,5,5,1,0,1,0,15204,7.0,17694,182,40,-1578,-1724,18.2,1520.4,17,1,0,5,5,8,0,0,0,0,16782,7.2,19418,250,55,1578,1724,25.0,1678.2
4486211322,0,37,2,0,5,4,4,0,0,0,0,16273,7.2,19371,241,48,1161,2387,24.1,1627.3,14,1,1,4,5,3,1,1,0,0,15112,6.6,16984,224,44,-1161,-2387,22.4,1511.2
4523264320,0,78,1,1,4,10,7,0,0,0,0,15035,6.4,16650,183,60,-3584,-3248,18.3,1503.5,13,2,0,10,4,10,1,1,0,0,18619,7.6,19898,238,59,3584,3248,23.8,1861.9
4471530570,0,20,3,0,8,9,7,2,1,1,0,17299,7.0,18331,218,48,-1143,-1447,21.8,1729.9,16,7,1,9,8,6,0,0,0,0,18442,7.2,19778,233,60,1143,1447,23.3,1844.2
4513226809,0,93,4,1,7,4,6,0,0,0,0,17129,6.8,17586,228,36,1440,247,22.8,1712.9,15,5,0,4,7,4,1,1,0,0,15689,7.0,17339,211,60,-1440,-247,21.1,1568.9
4512960247,0,14,2,0,8,7,3,0,0,0,0,17113,7.2,19396,234,49,815,1397,23.4,1711.3,15,2,1,7,8,4,0,0,0,0,16298,6.8,17999,182,52,-815,-1397,18.2,1629.8
4524332447,1,18,4,0,5,4,3,1,1,0,0,15296,6.8,16908,187,56,733,810,18.7,1529.6,24,4,1,4,5,1,0,0,0,0,14563,6.2,16098,204,32,-733,-810,20.4,1456.3
4524504649,0,15,3,1,10,4,15,2,1,1,0,18959,7.2,19473,244,60,3373,1784,24.4,1895.9,13,2,0,4,10,2,0,0,0,0,15586,6.8,17689,221,47,-3373,-1784,22.1,1558.6
4516849769,0,13,2,1,5,12,5,0,0,0,0,15230,6.4,15161,185,44,-3832,-3915,18.5,1523.0,16,0,0,12,5,11,1,1,0,0,19062,7.4,19076,219,58,3832,3915,21.9,1906.2
4445820546,0,12,2,0,5,22,4,0,0,0,0,15077,6.4,15707,138,52,-7278,-6021,13.8,1507.7,14,1,1,22,5,12,0,0,0,0,22355,8.0,21728,229,36,7278,6021,22.9,2235.5
4466299891,1,19,3,0,2,5,2,0,0,0,0,15292,6.8,17578,252,52,-1774,-2576,25.2,1529.2,38,5,1,5,2,4,1,1,0,0,17066,7.6,20154,267,72,1774,2576,26.7,1706.6
4518281398,1,22,2,1,4,5,3,0,0,0,0,15392,7.0,17929,222,52,-982,-1613,22.2,1539.2,15,2,0,5,4,3,1,1,0,0,16374,7.4,19542,234,64,982,1613,23.4,1637.4
4511363738,1,17,0,1,10,4,14,1,0,1,0,19271,7.2,18923,245,44,4290,1900,24.5,1927.1,12,2,0,4,10,7,0,0,0,0,14981,6.8,17023,193,53,-4290,-1900,19.3,1498.1
4515999834,1,16,1,1,10,10,13,0,0,0,0,17917,6.8,17997,199,44,-1074,-1029,19.9,1791.7,18,2,0,10,10,9,1,1,0,0,18991,7.2,19026,233,56,1074,1029,23.3,1899.1
4524444788,1,14,1,1,5,6,4,0,0,0,0,16481,7.2,18268,221,53,563,-1127,22.1,1648.1,14,2,0,6,5,4,1,1,0,0,15918,7.2,19395,217,52,-563,1127,21.7,1591.8
4526187847,0,15,6,0,4,10,3,0,0,0,0,15119,6.4,16068,201,28,-3770,-2959,20.1,1511.9,13,2,1,10,4,12,0,0,0,0,18889,7.0,19027,213,59,3770,2959,21.3,1888.9
4478937217,1,43,4,1,13,4,24,1,1,0,0,19669,7.0,17978,207,32,6876,6535,20.7,1966.9,15,0,0,4,13,8,0,0,0,0,12793,5.2,11443,149,8,-6876,-6535,14.9,1279.3
4521580366,0,32,3,0,6,10,5,1,0,1,0,16406,7.0,17714,208,55,-1530,-988,20.8,1640.6,14,4,1,10,6,10,1,1,0,0,17936,7.0,18702,224,56,1530,988,22.4,1793.6
4497173280,1,18,2,1,11,9,5,0,0,0,0,18702,7.4,18736,234,53,1713,1791,23.4,1870.2,15,3,0,9,11,6,0,0,0,0,16989,6.6,16945,179,38,-1713,-1791,17.9,1698.9
4515880497,1,16,3,0,5,4,6,0,0,0,0,16632,7.0,18912,233,53,1224,1259,23.3,1663.2,39,3,1,4,5,5,1,1,0,0,15408,6.8,17653,228,40,-1224,-1259,22.8,1540.8
4523651939,0,17,3,0,2,4,4,0,0,0,0,13298,6.6,16659,192,37,-3826,-2595,19.2,1329.8,14,3,1,4,2,5,1,1,0,0,17124,7.2,19254,250,74,3826,2595,25.0,1712.4
4484160987,1,16,2,0,3,6,6,1,1,0,0,15335,6.6,17217,219,49,-839,-82,21.9,1533.5,14,2,1,6,3,5,0,0,0,0,16174,7.0,17299,225,36,839,82,22.5,1617.4
4420481816,0,18,4,0,8,3,7,1,0,1,0,17574,7.2,19195,252,44,2774,2207,25.2,1757.4,15,4,1,3,8,2,1,1,0,0,14800,6.6,16988,225,47,-2774,-2207,22.5,1480.0
4524352640,1,19,0,1,7,6,8,0,0,0,0,16877,6.8,17631,216,37,338,-272,21.6,1687.7,32,1,0,6,7,9,1,1,0,0,16539,7.0,17903,230,38,-338,272,23.0,1653.9
4461308775,0,51,3,1,8,8,12,0,0,0,0,16017,6.2,15395,157,40,517,-593,15.7,1601.7,16,4,0,8,8,7,0,0,0,0,15500,6.4,15988,170,44,-517,593,17.0,1550.0
4523609898,0,122,1,1,3,3,3,1,1,0,0,15474,6.8,17407,203,64,-347,-1134,20.3,1547.4,11,0,0,3,3,5,0,0,0,0,15821,7.2,18541,224,63,347,1134,22.4,1582.1
4495435379,1,105,2,1,9,5,9,1,0,1,0,17795,7.4,19812,237,71,1367,1620,23.7,1779.5,29,2,0,5,9,4,1,1,0,0,16428,7.0,18192,217,60,-1367,-1620,21.7,1642.8
4470670940,1,18,3,1,6,6,7,0,0,0,0,16247,7.4,19667,218,52,266,1738,21.8,1624.7,14,5,0,6,6,8,1,1,0,0,15981,7.0,17929,213,56,-266,-1738,21.3,1598.1
4479961520,1,14,2,0,5,4,4,0,0,0,0,16656,7.2,18582,252,42,930,275,25.2,1665.6,13,3,1,4,5,6,0,0,0,0,15726,7.2,18307,205,48,-930,-275,20.5,1572.6
4519183876,1,15,1,1,11,3,11,2,1,1,0,18866,7.6,20876,214,60,3650,3906,21.4,1886.6,11,1,0,3,11,4,0,0,0,0,15216,6.8,16970,219,44,-3650,-3906,21.9,1521.6
4520401990,0,16,2,1,9,9,9,0,0,0,0,17197,7.2,18127,205,40,-1383,-970,20.5,1719.7,14,2,0,9,9,12,0,0,0,0,18580,7.0,19097,232,51,1383,970,23.2,1858.0
4455468976,1,17,3,1,4,7,3,1,1,0,0,15859,7.0,18955,250,62,-898,-655,25.0,1585.9,17,5,0,7,4,9,0,0,0,0,16757,7.0,19610,193,59,898,655,19.3,1675.7
4470281349,1,16,1,1,6,4,6,1,1,0,0,16496,7.0,17575,213,61,615,12,21.3,1649.6,15,2,0,4,6,4,0,0,0,0,15881,6.8,17563,227,40,-615,-12,22.7,1588.1
4521689217,0,16,2,0,3,7,2,1,1,0,0,15252,7.0,18024,224,56,-1293,-380,22.4,1525.2,38,3,1,7,3,8,0,0,0,0,16545,7.0,18404,219,48,1293,380,21.9,1654.5
4523258909,0,57,3,1,8,7,5,0,0,0,0,16204,6.6,17473,184,47,-1016,-1306,18.4,1620.4,17,4,0,7,8,7,1,1,0,0,17220,7.0,18779,210,51,1016,1306,21.0,1722.0
4509560405,1,15,0,0,19,4,22,1,1,0,0,22173,7.4,20408,234,45,7154,6032,23.4,2217.3,12,0,1,4,19,5,1,0,1,0,15019,6.0,14376,189,38,-7154,-6032,18.9,1501.9
4468797183,1,10,2,0,7,7,6,2,1,1,2,19453,7.0,18832,239,64,3773,1957,23.9,1945.3,13,0,1,7,7,6,0,0,0,0,15680,6.6,16875,170,52,-3773,-1957,17.0,1568.0
4527545380,1,14,3,1,10,8,17,1,0,1,0,17799,7.0,18078,190,40,-333,-359,19.0,1779.9,16,3,0,8,10,7,1,1,0,0,18132,7.2,18437,241,59,333,359,24.1,1813.2
4523397279,1,20,13,0,3,7,1,0,0,0,0,14068,6.8,17057,206,40,-3083,-2239,20.6,1406.8,41,6,1,7,3,6,0,0,0,0,17151,7.0,19296,252,32,3083,2239,25.2,1715.1
4516926779,1,17,3,1,5,5,6,1,1,0,0,16191,7.2,18795,238,46,290,617,23.8,1619.1,15,3,0,5,5,3,0,0,0,0,15901,7.2,18178,242,44,-290,-617,24.2,1590.1
4499790153,1,13,5,1,5,7,7,0,0,0,0,15861,6.8,17523,182,60,-1340,-228,18.2,1586.1,15,3,0,7,5,7,2,1,1,0,17201,6.8,17751,204,56,1340,228,20.4,1720.1
4521401653,0,12,3,0,4,9,4,0,0,0,0,15944,7.0,17805,201,71,-2600,-1587,20.1,1594.4,12,1,1,9,4,13,1,1,0,0,18544,7.2,19392,251,53,2600,1587,25.1,1854.4
4521025798,1,14,2,0,4,3,3,1,1,0,0,16374,7.0,18573,263,57,825,1066,26.3,1637.4,15,5,1,3,4,6,0,0,0,0,15549,6.6,17507,253,46,-825,-1066,25.3,1554.9
4516768081,0,17,2,0,4,5,4,0,0,0,0,15714,6.8,17852,243,63,-46,-458,24.3,1571.4,13,3,1,5,4,4,2,1,1,0,15760,7.2,18310,193,56,46,458,19.3,1576.0
4511489800,1,37,2,1,10,8,16,1,0,1,0,19376,7.2,19330,241,35,2068,1158,24.1,1937.6,11,0,0,8,10,7,0,0,0,0,17308,6.8,18172,204,49,-2068,-1158,20.4,1730.8
4514407181,0,17,1,1,6,7,8,1,1,0,0,16088,7.2,17857,205,62,-769,-217,20.5,1608.8,16,0,0,7,6,7,1,0,1,0,16857,7.0,18074,202,62,769,217,20.2,1685.7
4496878235,0,13,1,0,1,4,0,0,0,0,0,13649,6.0,14620,189,41,-2564,-2920,18.9,1364.9,68,2,1,4,1,6,0,0,0,0,16213,6.8,17540,213,72,2564,2920,21.3,1621.3
4513729345,1,16,4,1,2,3,1,0,0,0,0,15572,7.2,19166,242,83,902,860,24.2,1557.2,17,0,0,3,2,4,1,1,0,0,14670,6.8,18306,231,47,-902,-860,23.1,1467.0
4518530813,0,23,3,0,11,6,12,0,0,0,0,17944,7.0,17835,214,30,901,144,21.4,1794.4,21,7,1,6,11,5,0,0,0,0,17043,6.8,17691,230,53,-901,-144,23.0,1704.3
4513437508,1,14,3,1,7,1,5,0,0,0,0,16961,7.2,19188,245,43,4060,3257,24.5,1696.1,16,0,0,1,7,1,0,0,0,0,12901,6.4,15931,176,45,-4060,-3257,17.6,1290.1
4497064417,1,14,2,1,10,1,10,2,1,1,0,19847,7.2,20768,250,64,6658,6189,25.0,1984.7,11,0,0,1,10,2,0,0,0,0,13189,6.2,14579,166,55,-6658,-6189,16.6,1318.9
4475880508,0,18,4,0,8,13,4,0,0,0,0,16735,7.0,17923,202,28,-2187,-2383,20.2,1673.5,49,5,1,13,8,15,1,1,0,0,18922,7.2,20306,208,46,2187,2383,20.8,1892.2
4459617456,0,41,5,1,8,4,9,0,0,0,0,18073,7.6,21032,239,44,2364,2384,23.9,1807.3,12,4,0,4,8,2,0,0,0,0,15709,7.0,18648,233,62,-2364,-2384,23.3,1570.9
4524708254,1,16,5,1,8,5,16,2,1,1,0,16693,6.4,16725,187,32,2123,1219,18.7,1669.3,14,3,0,5,8,1,0,0,0,0,14570,6.2,15506,172,51,-2123,-1219,17.2,1457.0
4474899637,1,18,3,0,6,5,4,2,1,1,0,16787,7.2,18618,253,52,534,154,25.3,1678.7,17,3,1,5,6,10,0,0,0,0,16253,7.2,18464,197,75,-534,-154,19.7,1625.3
4522415316,0,15,1,1,6,3,6,0,0,0,0,15941,7.2,17560,228,33,1231,93,22.8,1594.1,84,1,0,3,6,3,0,0,0,0,14710,6.8,17467,212,43,-1231,-93,21.2,1471.0
4526195389,1,18,3,1,4,6,2,1,0,1,0,15500,6.8,17374,218,56,-1006,-1606,21.8,1550.0,45,3,0,6,4,5,1,1,0,0,16506,7.2,18980,221,48,1006,1606,22.1,1650.6
4496999459,1,18,5,0,0,3,0,0,0,0,0,13691,6.8,16957,229,54,-1148,-818,22.9,1369.1,17,4,1,3,0,2,0,0,0,0,14839,6.8,17775,221,51,1148,818,22.1,1483.9
4503353744,0,13,1,0,2,9,3,1,0,1,0,15325,6.8,17258,238,53,-2368,-250,23.8,1532.5,16,2,1,9,2,14,1,1,0,0,17693,7.0,17508,201,48,2368,250,20.1,1769.3
4464260583,0,142,1,0,4,5,4,0,0,0,0,14569,6.6,17180,194,49,-1195,-56,19.4,1456.9,13,3,1,5,4,6,1,1,0,0,15764,6.6,17236,194,54,1195,56,19.4,1576.4
4519767610,1,17,5,0,6,5,8,0,0,0,0,16285,7.0,17681,230,44,160,-337,23.0,1628.5,16,2,1,5,6,8,0,0,0,0,16125,6.8,18018,204,64,-160,337,20.4,1612.5
4516639706,1,13,2,0,2,2,3,0,0,0,0,15397,6.8,17958,247,44,908,-79,24.7,1539.7,16,2,1,2,2,1,2,1,1,0,14489,6.8,18037,221,60,-908,79,22.1,1448.9
4523659113,1,10,3,0,7,7,7,0,0,0,0,17152,6.8,18219,223,48,629,753,22.3,1715.2,16,1,1,7,7,9,1,1,0,0,16523,6.8,17466,212,44,-629,-753,21.2,1652.3
4519619414,1,12,1,0,6,8,7,1,0,1,1,18155,7.0,19429,231,65,468,558,23.1,1815.5,12,3,1,8,6,11,1,1,0,0,17687,7.0,18871,194,56,-468,-558,19.4,1768.7
4519722602,0,16,3,1,7,6,8,1,1,0,0,16646,6.6,16213,204,44,592,-875,20.4,1664.6,30,3,0,6,7,8,0,0,0,0,16054,6.6,17088,204,56,-592,875,20.4,1605.4
4513553506,1,39,1,1,8,11,8,0,0,0,0,17072,6.8,17724,180,63,-2298,-730,18.0,1707.2,13,2,0,11,8,5,2,1,1,1,19370,7.0,18454,242,48,2298,730,24.2,1937.0
4520915828,0,16,0,0,13,7,19,1,1,0,0,19609,7.0,17551,207,32,3454,175,20.7,1960.9,13,2,1,7,13,6,0,0,0,0,16155,6.8,17376,201,45,-3454,-175,20.1,1615.5
4458615425,0,25,1,0,3,12,2,0,0,0,0,15197,6.8,17692,223,60,-3960,-1446,22.3,1519.7,93,4,1,12,3,15,2,1,1,0,19157,7.0,19138,216,52,3960,1446,21.6,1915.7
4510968439,1,13,0,1,3,3,3,1,1,0,0,15271,7.0,18226,236,55,-455,-767,23.6,1527.1,11,2,0,3,3,3,0,0,0,0,15726,7.2,18993,258,59,455,767,25.8,1572.6
4508006237,1,10,3,0,4,8,5,0,0,0,0,14689,6.6,16546,174,55,-3860,-1719,17.4,1468.9,19,0,1,8,4,4,2,1,1,1,18549,7.2,18265,253,42,3860,1719,25.3,1854.9
4492509344,1,18,3,0,4,3,3,1,1,0,0,15442,7.2,18590,220,64,-79,-815,22.0,1544.2,51,3,1,3,4,4,1,0,1,0,15521,7.2,19405,217,72,79,815,21.7,1552.1
4497457937,1,41,3,1,4,8,4,0,0,0,0,16059,7.0,18190,221,41,-1521,-2185,22.1,1605.9,19,24,0,8,4,14,1,1,0,0,17580,7.4,20375,246,50,1521,2185,24.6,1758.0
4477447831,1,19,4,0,6,5,8,1,1,0,0,15416,6.8,17061,199,55,-1342,-713,19.9,1541.6,34,4,1,5,6,7,0,0,0,0,16758,6.8,17774,248,50,1342,713,24.8,1675.8
4511823167,0,32,1,0,4,2,3,0,0,0,0,15008,6.8,17416,225,40,1219,1558,22.5,1500.8,16,17,1,2,4,1,1,1,0,0,13789,6.6,15858,193,44,-1219,-1558,19.3,1378.9
4468744263,0,22,4,0,7,6,11,0,0,0,0,16587,6.8,17801,216,44,-674,909,21.6,1658.7,20,6,1,6,7,8,0,0,0,0,17261,6.6,16892,219,34,674,-909,21.9,1726.1
4522030672,1,17,3,0,1,1,1,1,0,1,0,14969,6.8,17547,252,48,1089,33,25.2,1496.9,49,2,1,1,1,0,0,0,0,0,13880,6.8,17514,212,47,-1089,-33,21.2,1388.0
4526227837,1,15,2,0,11,7,9,0,0,0,0,19425,7.4,20998,218,67,3143,2852,21.8,1942.5,16,2,1,7,11,5,1,1,0,0,16282,7.0,18146,216,56,-3143,-2852,21.6,1628.2
4523437781,0,18,2,0,3,10,4,1,1,0,0,14878,6.4,16786,213,47,-4657,-4000,21.3,1487.8,39,4,1,10,3,11,0,0,0,1,19535,7.6,20786,244,56,4657,4000,24.4,1953.5
4523295777,1,41,3,1,8,7,6,2,1,1,0,17287,7.0,18953,215,62,817,266,21.5,1728.7,18,4,0,7,8,7,0,0,0,0,16470,7.2,18687,218,56,-817,-266,21.8,1647.0
4476720209,1,15,3,0,6,4,3,1,1,0,0,15981,7.0,18320,219,60,354,1465,21.9,1598.1,18,5,1,4,6,4,0,0,0,0,15627,6.6,16855,217,47,-354,-1465,21.7,1562.7
4518609876,0,16,2,0,4,3,2,1,1,0,0,15654,7.2,18324,233,46,-360,-61,23.3,1565.4,10,1,1,3,4,2,1,0,1,0,16014,7.0,18385,254,64,360,61,25.4,1601.4
4520349175,1,16,6,0,8,5,10,0,0,0,0,17258,6.8,17683,216,52,2310,1946,21.6,1725.8,20,0,1,5,8,5,0,0,0,0,14948,6.6,15737,176,40,-2310,-1946,17.6,1494.8
4515393981,1,18,4,1,5,6,6,2,1,1,1,17843,7.0,17948,243,48,1895,-224,24.3,1784.3,14,3,0,6,5,6,0,0,0,0,15948,7.0,18172,207,47,-1895,224,20.7,1594.8
4465188797,0,14,1,1,6,7,5,0,0,0,0,15891,7.0,17964,207,41,-1190,-911,20.7,1589.1,14,1,0,7,6,4,0,0,0,0,17081,7.0,18875,224,54,1190,911,22.4,1708.1
4496026567,0,20,13,0,5,8,6,0,0,0,0,15356,6.8,16700,207,36,-2416,-3217,20.7,1535.6,42,3,1,8,5,8,0,0,0,0,17772,7.4,19917,239,62,2416,3217,23.9,1777.2
4518246910,1,17,0,0,10,3,5,1,1,0,0,18863,7.2,19070,228,68,4747,2924,22.8,1886.3,11,0,1,3,10,5,0,0,0,0,14116,6.6,16146,189,43,-4747,-2924,18.9,1411.6
4453252980,0,42,5,0,0,9,0,0,0,0,0,13024,6.6,15869,192,48,-4912,-4457,19.2,1302.4,19,8,1,9,0,5,2,1,1,0,17936,7.4,20326,251,51,4912,4457,25.1,1793.6
4520687269,0,63,6,0,9,4,5,0,0,0,0,18184,7.4,20169,238,52,2989,4519,23.8,1818.4,23,18,1,4,9,6,0,0,0,0,15195,6.4,15650,192,44,-2989,-4519,19.2,1519.5
4527328845,0,19,3,1,2,7,3,0,0,0,0,14695,6.8,16615,222,49,-2240,-4314,22.2,1469.5,17,2,0,7,2,2,1,1,0,0,16935,7.4,20929,249,77,2240,4314,24.9,1693.5
4495300852,1,15,5,1,13,3,13,0,0,0,0,20183,7.6,20925,239,48,5712,4581,23.9,2018.3,14,3,0,3,13,3,0,0,0,0,14471,6.6,16344,208,36,-5712,-4581,20.8,1447.1
4489343082,1,17,2,1,9,2,12,1,1,0,0,18581,6.8,17855,229,55,4279,1907,22.9,1858.1,13,2,0,2,9,3,0,0,0,0,14302,6.4,15948,239,44,-4279,-1907,23.9,1430.2
4512808961,0,17,4,0,5,11,5,1,1,0,0,16280,6.6,17350,199,48,-2198,-1633,19.9,1628.0,15,3,1,11,5,15,0,0,0,0,18478,7.2,18983,188,46,2198,1633,18.8,1847.8
4517734414,1,12,1,1,10,2,5,1,1,0,0,18717,7.4,20051,247,57,4865,4641,24.7,1871.7,15,0,0,2,10,4,0,0,0,0,13852,6.6,15410,191,32,-4865,-4641,19.1,1385.2
4486714617,0,21,2,0,1,8,1,0,0,0,0,14022,6.8,16586,223,59,-4075,-3154,22.3,1402.2,15,2,1,8,1,7,2,1,1,1,18097,7.2,19740,211,60,4075,3154,21.1,1809.7
4510873008,1,12,1,0,3,8,5,2,1,1,0,14591,6.2,15636,177,55,-2658,-3328,17.7,1459.1,41,2,1,8,3,9,0,0,0,0,17249,7.0,18964,209,52,2658,3328,20.9,1724.9
4508799837,1,16,1,0,6,4,6,1,0,1,1,18625,7.4,19348,240,50,3163,1231,24.0,1862.5,16,2,1,4,6,6,1,1,0,0,15462,7.0,18117,230,46,-3163,-1231,23.0,1546.2
4522863300,0,16,2,0,5,11,3,1,1,0,0,15594,6.6,16987,213,55,-2997,-2029,21.3,1559.4,18,6,1,11,5,14,0,0,0,0,18591,7.2,19016,222,46,2997,2029,22.2,1859.1
4522601125,1,19,1,1,7,3,12,2,1,1,0,17791,7.2,18557,250,48,2763,1017,25.0,1779.1,16,3,0,3,7,5,0,0,0,0,15028,6.8,17540,200,55,-2763,-1017,20.0,1502.8
4489945010,0,14,5,0,1,5,2,0,0,0,0,13736,6.6,15897,180,68,-2301,-2659,18.0,1373.6,15,2,1,5,1,3,2,1,1,0,16037,7.2,18556,226,60,2301,2659,22.6,1603.7
4525030965,1,36,1,1,11,6,10,1,0,1,0,18849,7.2,19086,220,65,3281,1747,22.0,1884.9,9,4,0,6,11,3,1,1,0,0,15568,6.8,17339,202,56,-3281,-1747,20.2,1556.8
4477496962,0,15,2,0,7,7,14,0,0,0,0,16750,6.6,17492,214,44,-2128,-1873,21.4,1675.0,18,4,1,7,7,3,2,1,1,1,18878,7.2,19365,236,72,2128,1873,23.6,1887.8
4500722833,1,25,3,1,6,1,9,1,1,0,0,17450,7.2,19276,233,44,3610,2295,23.3,1745.0,12,2,0,1,6,1,0,0,0,0,13840,6.4,16981,226,39,-3610,-2295,22.6,1384.0
4525005858,0,16,0,0,2,9,4,0,0,0,0,13631,6.6,15864,175,52,-5167,-3200,17.5,1363.1,12,1,1,9,2,7,0,0,0,0,18798,7.4,19064,234,44,5167,3200,23.4,1879.8
4477117307,0,18,1,1,4,6,8,0,0,0,0,15251,7.0,18342,197,39,-2343,-2231,19.7,1525.1,11,5,0,6,4,5,2,1,1,0,17594,7.4,20573,238,80,2343,2231,23.8,1759.4
4500092661,0,17,4,0,4,8,5,1,1,0,0,15591,7.0,17848,228,59,-1951,-1575,22.8,1559.1,19,4,1,8,4,6,0,0,0,0,17542,7.4,19423,236,42,1951,1575,23.6,1754.2
4514596262,0,46,5,0,2,7,2,0,0,0,0,14242,6.6,17184,212,50,-2954,-1250,21.2,1424.2,15,5,1,7,2,3,1,0,1,0,17196,7.0,18434,244,52,2954,1250,24.4,1719.6
4516616203,1,23,0,0,2,5,1,0,0,0,0,15508,7.0,17985,258,60,-919,-923,25.8,1550.8,11,2,1,5,2,8,0,0,0,0,16427,7.2,18908,226,48,919,923,22.6,1642.7
4524432145,0,16,3,0,2,9,2,0,0,0,0,14085,6.4,15408,220,38,-3803,-4020,22.0,1408.5,18,1,1,9,2,4,2,1,1,0,17888,7.2,19428,245,60,3803,4020,24.5,1788.8
4503411816,1,17,3,1,5,1,6,0,0,0,0,16733,7.2,19698,231,62,1901,1126,23.1,1673.3,14,4,0,1,5,1,2,1,1,0,14832,7.0,18572,239,68,-1901,-1126,23.9,1483.2
4476265926,1,39,5,1,10,4,11,0,0,0,0,18228,7.2,19423,250,36,3419,4709,25.0,1822.8,14,2,0,4,10,2,1,1,0,0,14809,6.2,14714,193,41,-3419,-4709,19.3,1480.9
4459496289,0,18,0,0,11,8,7,0,0,0,0,18303,7.2,19278,220,52,1142,841,22.0,1830.3,13,5,1,8,11,7,0,0,0,0,17161,7.0,18437,201,56,-1142,-841,20.1,1716.1
4512472589,1,15,2,1,3,7,3,1,1,0,0,15199,6.8,17382,235,45,-1631,-1338,23.5,1519.9,14,2,0,7,3,7,1,0,1,0,16830,7.0,18720,206,49,1631,1338,20.6,1683.0
4508732146,1,86,1,1,13,10,15,0,0,0,0,20067,7.0,18286,206,43,2778,-247,20.6,2006.7,17,2,0,10,13,4,1,1,0,0,17289,7.0,18533,184,44,-2778,247,18.4,1728.9
4523957266,0,19,2,0,4,7,2,0,0,0,0,15649,7.2,18614,234,66,-1975,-1115,23.4,1564.9,24,4,1,7,4,7,1,1,0,0,17624,7.2,19729,243,55,1975,1115,24.3,1762.4
4450404129,0,17,8,1,8,5,12,1,1,0,0,17551,6.6,17463,237,43,1763,-239,23.7,1755.1,20,4,0,5,8,6,0,0,0,0,15788,7.0,17702,213,45,-1763,239,21.3,1578.8
4525614725,1,15,1,1,8,4,7,0,0,0,0,17972,7.4,19649,254,37,2455,2080,25.4,1797.2,14,0,0,4,8,3,0,0,0,0,15517,6.8,17569,214,57,-2455,-2080,21.4,1551.7
4523821481,1,15,6,1,14,3,17,1,1,0,0,20005,7.4,20561,222,68,5201,4398,22.2,2000.5,71,1,0,3,14,3,0,0,0,0,14804,6.6,16163,211,44,-5201,-4398,21.1,1480.4
4513512773,1,15,2,0,5,5,4,0,0,0,0,16450,7.2,18742,222,72,296,1046,22.2,1645.0,12,4,1,5,5,8,2,1,1,0,16154,7.0,17696,220,60,-296,-1046,22.0,1615.4
4508607080,1,39,4,0,10,10,12,0,0,0,0,17860,7.0,17673,182,52,-268,407,18.2,1786.0,15,4,1,10,10,16,0,0,0,0,18128,6.8,17266,199,40,268,-407,19.9,1812.8
4525569864,0,39,3,0,5,3,5,1,0,1,0,15824,7.2,19141,221,52,225,1404,22.1,1582.4,128,3,1,3,5,6,1,1,0,0,15599,6.8,17737,248,60,-225,-1404,24.8,1559.9
4493323952,1,17,4,0,8,3,14,0,0,0,1,18823,6.6,18188,245,47,4509,2253,24.5,1882.3,14,4,1,3,8,2,1,1,0,0,14314,6.6,15935,218,40,-4509,-2253,21.8,1431.4
4492702497,1,15,2,1,8,2,12,0,0,0,0,17253,7.2,18869,218,40,1887,519,21.8,1725.3,12,0,0,2,8,3,1,1,0,0,15366,7.0,18350,233,76,-1887,-519,23.3,1536.6
4517859191,0,17,3,0,3,11,3,0,0,0,0,14595,6.4,15064,161,59,-3619,-4011,16.1,1459.5,47,2,1,11,3,9,1,1,0,0,18214,7.2,19075,222,54,3619,4011,22.2,1821.4
4520718276,0,16,3,1,4,10,4,1,0,1,0,15773,6.6,16701,216,44,-2175,-2305,21.6,1577.3,23,3,0,10,4,12,1,1,0,0,17948,7.2,19006,216,42,2175,2305,21.6,1794.8
4500702645,0,20,5,0,6,5,10,0,0,0,0,17160,7.0,18228,241,47,1497,717,24.1,1716.0,17,7,1,5,6,4,1,1,0,0,15663,6.8,17511,218,40,-1497,-717,21.8,1566.3
4526530551,0,14,3,0,3,7,2,1,1,0,0,14344,6.6,16049,193,63,-4269,-3208,19.3,1434.4,17,4,1,7,3,5,0,0,0,1,18613,7.2,19257,232,63,4269,3208,23.2,1861.3
4494648390,0,15,3,1,6,8,8,0,0,0,0,15697,6.8,16449,196,44,-1237,-285,19.6,1569.7,14,2,0,8,6,13,0,0,0,0,16934,6.4,16734,201,47,1237,285,20.1,1693.4
4477518558,1,19,1,0,9,8,13,1,1,0,0,17813,6.8,17461,202,66,986,549,20.2,1781.3,15,2,1,8,9,13,0,0,0,0,16827,6.6,16912,216,39,-986,-549,21.6,1682.7
4492730038,0,19,4,1,3,5,6,0,0,0,0,15834,6.8,18088,228,56,-191,-182,22.8,1583.4,145,5,0,5,3,6,1,1,0,0,16025,7.2,18270,208,52,191,182,20.8,1602.5
4515997665,1,12,5,1,5,6,7,0,0,0,0,16688,7.0,18697,247,49,1008,-248,24.7,1668.8,44,3,0,6,5,5,1,1,0,0,15680,7.4,18945,199,51,-1008,248,19.9,1568.0
4524934660,1,17,3,1,5,1,4,1,1,0,0,15823,7.0,17964,197,48,2028,1165,19.7,1582.3,13,3,0,1,5,1,0,0,0,0,13795,6.8,16799,205,46,-2028,-1165,20.5,1379.5
4523654573,1,12,3,1,7,4,6,1,1,0,0,17914,7.0,18528,240,62,3410,2524,24.0,1791.4,38,1,0,4,7,7,0,0,0,0,14504,6.4,16004,187,48,-3410,-2524,18.7,1450.4
4526437692,1,17,0,1,7,9,11,0,0,0,0,16752,7.0,18525,226,42,-753,-299,22.6,1675.2,14,1,0,9,7,6,0,0,0,0,17505,7.0,18824,225,51,753,299,22.5,1750.5
4436942531,0,19,5,1,9,6,10,0,0,0,0,16544,6.6,16417,191,41,1239,568,19.1,1654.4,47,2,0,6,9,8,1,0,1,0,15305,6.4,15849,179,41,-1239,-568,17.9,1530.5
4521907618,0,13,3,0,6,8,8,1,0,1,1,18234,6.6,17526,205,59,1619,-575,20.5,1823.4,17,3,1,8,6,5,0,0,0,0,16615,7.0,18101,209,46,-1619,575,20.9,1661.5
4524823620,0,51,5,1,8,5,13,0,0,0,0,17663,6.8,18440,202,60,1942,890,20.2,1766.3,39,2,0,5,8,3,1,0,1,0,15721,6.8,17550,205,58,-1942,-890,20.5,1572.1
4504690323,0,20,2,0,2,6,2,2,1,1,0,15488,6.8,18660,265,67,-978,-226,26.5,1548.8,20,2,1,6,2,8,0,0,0,0,16466,7.2,18886,220,43,978,226,22.0,1646.6
4468533756,1,17,3,1,17,5,16,1,1,0,0,20218,7.2,18620,199,40,4899,2415,19.9,2021.8,16,2,0,5,17,5,0,0,0,0,15319,6.4,16205,165,61,-4899,-2415,16.5,1531.9
4519402514,0,13,3,0,2,5,2,1,0,1,0,14652,6.8,17192,205,52,-458,-559,20.5,1465.2,14,0,1,5,2,3,1,1,0,0,15110,6.8,17751,210,52,458,559,21.0,1511.0
4512586696,1,21,2,0,4,6,8,0,0,0,0,15235,6.8,17736,208,59,-1089,378,20.8,1523.5,17,4,1,6,4,8,1,1,0,0,16324,6.6,17358,208,50,1089,-378,20.8,1632.4
4499542309,1,11,2,0,4,7,3,0,0,0,0,15562,6.8,17869,225,48,-435,-427,22.5,1556.2,15,2,1,7,4,8,1,1,0,0,15997,7.0,18296,196,65,435,427,19.6,1599.7
4467390349,0,17,3,1,4,10,4,0,0,0,0,14450,6.4,16178,191,44,-4625,-3193,19.1,1445.0,15,4,0,10,4,11,0,0,0,0,19075,7.2,19371,236,53,4625,3193,23.6,1907.5
4493965558,1,77,4,0,7,7,9,1,1,0,0,16937,7.0,18017,214,49,375,-566,21.4,1693.7,17,2,1,7,7,7,0,0,0,0,16562,7.0,18583,194,49,-375,566,19.4,1656.2
4489773127,0,13,2,1,5,9,6,0,0,0,0,15061,6.4,16082,203,44,-1805,-2303,20.3,1506.1,18,2,0,9,5,8,1,1,0,0,16866,7.0,18385,201,49,1805,2303,20.1,1686.6
4470453534,0,14,3,1,5,8,5,0,0,0,0,16574,6.8,18040,231,48,-37,-382,23.1,1657.4,14,0,0,8,5,10,0,0,0,0,16611,7.0,18422,209,50,37,382,20.9,1661.1
4476291723,0,12,3,1,4,5,4,0,0,0,0,14538,6.6,16373,211,32,-3278,-1873,21.1,1453.8,19,1,0,5,4,5,1,0,1,1,17816,7.2,18246,255,51,3278,1873,25.5,1781.6
4518834172,1,20,3,1,4,4,2,0,0,0,0,14926,7.0,19450,203,59,-842,2032,20.3,1492.6,15,4,0,4,4,7,1,0,1,0,15768,7.0,17418,243,47,842,-2032,24.3,1576.8
4510972926,0,14,2,1,8,9,7,0,0,0,0,16617,7.0,17480,184,44,-985,-1441,18.4,1661.7,21,2,0,9,8,7,1,1,0,0,17602,7.2,18921,222,55,985,1441,22.2,1760.2
4522136543,1,11,3,0,6,8,6,2,1,1,0,16618,7.0,17861,206,69,-702,746,20.6,1661.8,16,1,1,8,6,11,0,0,0,0,17320,6.4,17115,206,38,702,-746,20.6,1732.0
4504872920,0,15,2,1,5,3,6,0,0,0,0,16478,6.8,17590,254,44,1207,-488,25.4,1647.8,38,3,0,3,5,6,2,1,1,0,15271,7.2,18078,212,72,-1207,488,21.2,1527.1
4524748805,0,14,1,1,2,7,2,0,0,0,0,14377,7.0,17408,194,55,-3773,-3783,19.4,1437.7,14,1,0,7,2,8,1,1,0,0,18150,7.8,21191,258,52,3773,3783,25.8,1815.0
4507786946,1,16,2,1,7,6,7,2,1,1,0,17453,7.0,17851,237,49,1478,483,23.7,1745.3,36,2,0,6,7,8,0,0,0,0,15975,7.0,17368,199,62,-1478,-483,19.9,1597.5
4524031619,0,19,5,1,3,7,4,1,1,0,0,15311,6.8,16384,234,46,-1768,-963,23.4,1531.1,15,3,0,7,3,12,1,0,1,0,17079,6.6,17347,217,44,1768,963,21.7,1707.9
4523260482,1,36,8,1,7,4,11,1,1,0,0,16482,6.6,16880,222,46,1086,756,22.2,1648.2,21,4,0,4,7,6,0,0,0,0,15396,6.4,16124,212,58,-1086,-756,21.2,1539.6
4473660797,0,15,0,0,10,9,13,2,1,1,0,17145,7.0,17904,192,45,-1464,-454,19.2,1714.5,15,3,1,9,10,5,0,0,0,0,18609,7.2,18358,226,46,1464,454,22.6,1860.9
4489726898,1,15,1,1,3,0,3,1,1,0,0,15429,6.8,18375,218,64,1453,1251,21.8,1542.9,12,1,0,0,3,0,0,0,0,0,13976,6.6,17124,231,64,-1453,-1251,23.1,1397.6
4512481936,1,49,2,0,4,9,4,0,0,0,0,15370,6.6,17168,200,72,-2929,-1515,20.0,1537.0,18,2,1,9,4,13,1,1,0,0,18299,7.0,18683,217,62,2929,1515,21.7,1829.9
4524909030,0,52,0,0,6,4,7,1,0,1,0,16159,6.6,16943,208,44,1656,1298,20.8,1615.9,17,1,1,4,6,4,0,0,0,0,14503,6.4,15645,200,36,-1656,-1298,20.0,1450.3
4516933345,1,17,2,0,9,7,8,1,1,0,0,17661,6.6,17077,233,40,815,590,23.3,1766.1,17,3,1,7,9,10,0,0,0,0,16846,6.8,16487,191,38,-815,-590,19.1,1684.6
4482030809,0,12,2,0,6,11,6,0,0,0,0,17982,7.0,18687,244,56,-708,387,24.4,1798.2,9,3,1,11,6,9,1,1,0,0,18690,7.2,18300,203,44,708,-387,20.3,1869.0
4527645576,1,16,0,1,16,2,15,2,1,1,0,20943,7.4,19895,241,52,7847,5766,24.1,2094.3,17,1,0,2,16,2,0,0,0,0,13096,6.0,14129,142,52,-7847,-5766,14.2,1309.6
4483692276,1,15,2,1,6,5,7,1,0,1,0,17674,7.2,19752,225,80,2521,3096,22.5,1767.4,56,1,0,5,6,8,0,0,0,0,15153,6.6,16656,217,36,-2521,-3096,21.7,1515.3
4461165597,1,19,4,0,5,2,5,0,0,0,1,17169,7.0,18362,239,42,1574,1353,23.9,1716.9,18,2,1,2,5,3,2,1,1,0,15595,6.4,17009,252,54,-1574,-1353,25.2,1559.5
4521137660,0,51,2,0,3,4,5,1,1,0,0,14945,6.4,16491,215,50,-1696,-2153,21.5,1494.5,17,4,1,4,3,3,0,0,0,0,16641,7.0,18644,226,53,1696,2153,22.6,1664.1
4513438195,1,15,1,1,9,4,11,1,1,0,0,18585,7.2,18660,216,51,3161,2079,21.6,1858.5,13,2,0,4,9,4,0,0,0,0,15424,6.8,16581,185,68,-3161,-2079,18.5,1542.4
4508944628,0,14,3,1,2,5,3,1,1,0,0,15462,7.0,17729,249,66,-1176,-1499,24.9,1546.2,15,1,0,5,2,7,0,0,0,0,16638,7.2,19228,248,58,1176,1499,24.8,1663.8
4526246289,1,16,4,0,8,5,11,0,0,0,0,17770,7.0,17974,228,55,1753,963,22.8,1777.0,86,5,1,5,8,6,0,0,0,0,16017,6.8,17011,233,40,-1753,-963,23.3,1601.7
4524067975,0,14,6,0,1,6,1,0,0,0,0,13075,6.4,15488,169,56,-6309,-3115,16.9,1307.5,19,1,1,6,1,5,0,0,0,1,19384,7.2,18603,270,48,6309,3115,27.0,1938.4
4494610937,1,16,1,1,9,3,7,1,1,0,0,17764,7.4,19589,235,60,2617,2411,23.5,1776.4,32,3,0,3,9,2,0,0,0,0,15147,6.6,17178,220,56,-2617,-2411,22.0,1514.7
4505924248,0,15,3,0,2,5,3,0,0,0,0,14993,6.6,17018,241,44,-1481,-1877,24.1,1499.3,17,3,1,5,2,5,1,1,0,0,16474,7.2,18895,226,61,1481,1877,22.6,1647.4
4492994895,1,11,2,1,4,4,0,1,0,1,0,15620,7.2,18558,239,56,-1761,-385,23.9,1562.0,18,0,0,4,4,8,1,1,0,1,17381,7.4,18943,243,54,1761,385,24.3,1738.1
4452913051,1,19,1,1,6,3,6,2,1,1,0,17201,6.8,17943,186,67,2184,419,18.6,1720.1,48,3,0,3,6,4,0,0,0,0,15017,6.8,17524,211,52,-2184,-419,21.1,1501.7
4457608127,0,13,2,0,9,11,13,0,0,0,0,17498,7.2,18569,228,43,-958,264,22.8,1749.8,12,1,1,11,9,18,1,1,0,0,18456,7.2,18305,200,45,958,-264,20.0,1845.6
4486943775,1,13,2,1,16,5,16,1,0,1,0,20380,7.2,20228,230,36,5330,4040,23.0,2038.0,18,2,0,5,16,3,1,1,0,0,15050,6.6,16188,173,44,-5330,-4040,17.3,1505.0
4513601289,0,14,2,1,8,7,14,0,0,0,0,17077,6.6,16354,171,56,974,-1050,17.1,1707.7,16,1,0,7,8,4,1,1,0,0,16103,6.8,17404,200,48,-974,1050,20.0,1610.3
4515518787,0,11,0,0,3,7,3,0,0,0,0,14381,6.6,16919,202,41,-2528,-993,20.2,1438.1,14,0,1,7,3,10,1,1,0,0,16909,6.8,17912,196,51,2528,993,19.6,1690.9
4518305583,0,18,4,1,11,10,16,0,0,0,0,18453,7.0,18299,204,34,466,-316,20.4,1845.3,14,4,0,10,11,14,0,0,0,0,17987,7.4,18615,186,46,-466,316,18.6,1798.7
4509444763,1,17,1,0,3,7,2,0,0,0,0,15632,7.0,18400,232,72,-1822,-1467,23.2,1563.2,16,4,1,7,3,6,2,1,1,0,17454,7.4,19867,244,52,1822,1467,24.4,1745.4
4506382089,1,13,6,1,15,4,12,1,0,1,0,19987,7.2,19679,194,44,4805,3808,19.4,1998.7,16,1,0,4,15,4,1,1,0,0,15182,6.4,15871,194,45,-4805,-3808,19.4,1518.2
4524995748,0,20,1,0,2,7,3,1,1,0,0,14358,6.6,16775,225,53,-2031,-1121,22.5,1435.8,17,2,1,7,2,6,0,0,0,0,16389,7.0,17896,223,37,2031,1121,22.3,1638.9
4525943268,0,17,3,0,7,10,4,0,0,0,0,15970,6.8,17608,196,55,-2046,-691,19.6,1597.0,15,2,1,10,7,10,0,0,0,0,18016,7.0,18299,226,40,2046,691,22.6,1801.6
4471522569,1,18,3,0,8,6,6,2,1,1,0,17316,7.0,18199,206,68,767,796,20.6,1731.6,17,3,1,6,8,8,0,0,0,0,16549,6.8,17403,216,52,-767,-796,21.6,1654.9
4526148132,1,13,3,1,5,4,4,1,1,0,0,16328,6.8,17531,223,62,1192,836,22.3,1632.8,14,4,0,4,5,4,0,0,0,0,15136,6.4,16695,219,52,-1192,-836,21.9,1513.6
4500096958,1,14,4,0,4,9,7,1,0,1,0,14641,6.6,16376,171,60,-3174,-1926,17.1,1464.1,22,1,1,9,4,14,1,1,0,0,17815,7.0,18302,194,56,3174,1926,19.4,1781.5
4514596756,0,25,4,0,8,4,8,1,0,1,0,18057,7.0,18682,231,52,3152,2104,23.1,1805.7,16,2,1,4,8,4,0,0,0,0,14905,6.4,16578,211,40,-3152,-2104,21.1,1490.5
4526622617,1,19,3,0,11,8,8,0,0,0,0,17663,6.6,16879,193,30,16,-639,19.3,1766.3,15,4,1,8,11,6,2,1,1,0,17647,7.0,17518,227,42,-16,639,22.7,1764.7
4477637530,0,39,0,1,2,9,3,1,0,1,0,14157,6.4,16183,198,48,-3421,-2978,19.8,1415.7,16,3,0,9,2,10,1,1,0,0,17578,7.2,19161,238,48,3421,2978,23.8,1757.8
4527233294,1,14,12,1,8,8,12,0,0,0,0,16873,6.8,17879,215,45,375,296,21.5,1687.3,40,1,0,8,8,14,1,1,0,0,16498,7.0,17583,202,40,-375,-296,20.2,1649.8
4527031551,1,20,2,1,7,6,6,1,0,1,0,17131,6.6,17701,229,36,1254,-81,22.9,1713.1,13,2,0,6,7,3,1,1,0,0,15877,6.8,17782,199,62,-1254,81,19.9,1587.7
4495519418,0,13,2,1,10,3,12,0,0,0,0,17862,7.4,19955,242,44,2417,2101,24.2,1786.2,15,1,0,3,10,3,1,1,0,0,15445,7.0,17854,203,64,-2417,-2101,20.3,1544.5
4476661914,0,10,0,1,2,11,3,0,0,0,0,14562,6.8,16952,196,68,-4816,-3750,19.6,1456.2,12,1,0,11,2,12,1,1,0,0,19378,7.4,20702,259,48,4816,3750,25.9,1937.8
4458734669,0,19,7,1,3,4,3,1,0,1,0,14839,6.8,17590,205,53,-986,-1894,20.5,1483.9,98,6,0,4,3,3,1,1,0,0,15825,7.4,19484,250,48,986,1894,25.0,1582.5
4525005115,0,13,3,0,6,6,9,0,0,0,0,17924,7.0,18749,248,46,870,703,24.8,1792.4,17,1,1,6,6,9,0,0,0,0,17054,6.8,18046,241,39,-870,-703,24.1,1705.4
4505315494,0,11,2,1,6,5,6,1,1,0,0,16186,7.0,18472,225,43,53,-114,22.5,1618.6,12,0,0,5,6,5,0,0,0,0,16133,6.8,18586,205,56,-53,114,20.5,1613.3
4517551883,0,14,0,0,3,5,5,0,0,0,0,14979,6.8,17163,203,52,-1968,-2932,20.3,1497.9,38,3,1,5,3,6,1,1,0,0,16947,7.2,20095,238,72,1968,2932,23.8,1694.7
4462400484,1,12,2,1,2,2,0,0,0,0,0,15098,7.0,19226,239,64,-631,337,23.9,1509.8,23,2,0,2,2,2,1,1,0,0,15729,7.2,18889,258,76,631,-337,25.8,1572.9
4520727484,0,17,2,1,1,5,1,0,0,0,0,12713,6.0,14245,192,23,-2976,-2255,19.2,1271.3,14,1,0,5,1,8,2,1,1,0,15689,6.6,16500,237,44,2976,2255,23.7,1568.9
4521042540,1,14,2,1,8,7,7,1,1,0,0,18271,7.4,19689,223,55,938,181,22.3,1827.1,10,1,0,7,8,6,1,0,1,0,17333,7.2,19508,204,52,-938,-181,20.4,1733.3
4523812506,0,15,0,1,6,6,12,1,1,0,0,16434,6.8,18059,214,58,428,-939,21.4,1643.4,13,1,0,6,6,2,1,0,1,0,16006,7.2,18998,184,63,-428,939,18.4,1600.6
4508680387,0,14,3,0,9,9,10,1,1,0,0,17326,6.8,17581,188,50,54,-321,18.8,1732.6,85,0,1,9,9,8,0,0,0,0,17272,6.8,17902,193,44,-54,321,19.3,1727.2
4507806528,1,12,3,1,6,4,5,2,1,1,0,15994,6.8,18356,235,43,1396,2369,23.5,1599.4,12,0,0,4,6,4,0,0,0,0,14598,6.6,15987,166,56,-1396,-2369,16.6,1459.8
4522528063,1,17,2,0,4,1,4,0,0,0,0,16654,7.2,19392,255,59,1856,1530,25.5,1665.4,16,1,1,1,4,1,2,1,1,0,14798,6.8,17862,244,48,-1856,-1530,24.4,1479.8
4444365266,0,17,1,0,3,9,3,0,0,0,0,14323,6.4,15853,206,40,-3016,-3479,20.6,1432.3,16,6,1,9,3,4,1,1,0,0,17339,7.0,19332,235,56,3016,3479,23.5,1733.9
4439479847,0,12,3,1,4,5,4,1,1,0,0,16229,7.2,18834,247,48,960,813,24.7,1622.9,16,3,0,5,4,5,0,0,0,0,15269,6.8,18021,201,51,-960,-813,20.1,1526.9
4506260681,1,17,8,1,10,9,12,2,1,1,0,17869,6.8,17341,193,46,664,515,19.3,1786.9,22,3,0,9,10,9,0,0,0,0,17205,6.6,16826,202,37,-664,-515,20.2,1720.5
4520628924,0,16,1,0,5,5,5,0,0,0,0,15068,6.6,16740,208,26,-1933,-1659,20.8,1506.8,12,5,1,5,5,10,1,1,0,0,17001,7.2,18399,212,66,1933,1659,21.2,1700.1
4523410225,0,17,0,1,6,5,10,0,0,0,0,16233,7.0,17076,223,38,70,-928,22.3,1623.3,19,2,0,5,6,7,2,1,1,0,16163,7.0,18004,225,76,-70,928,22.5,1616.3
4511865277,0,42,5,0,7,11,6,0,0,0,0,16664,6.8,17627,214,48,-2262,-1763,21.4,1666.4,19,3,1,11,7,16,1,1,0,0,18926,7.4,19390,195,60,2262,1763,19.5,1892.6
4523278950,1,17,1,0,3,5,5,0,0,0,0,14313,6.2,15407,194,52,-2089,-2275,19.4,1431.3,18,6,1,5,3,7,1,1,0,0,16402,6.8,17682,243,48,2089,2275,24.3,1640.2
4521091433,0,19,3,0,10,10,15,0,0,0,0,18724,6.8,18411,221,33,622,319,22.1,1872.4,40,2,1,10,10,16,2,1,1,0,18102,7.0,18092,220,47,-622,-319,22.0,1810.2
4475185229,1,39,0,0,11,5,12,1,0,1,2,20920,7.2,19263,243,36,5418,3077,24.3,2092.0,12,0,1,5,11,8,0,0,0,0,15502,6.8,16186,173,47,-5418,-3077,17.3,1550.2
4521992457,0,16,0,1,7,4,10,1,1,0,0,16599,6.6,16723,201,40,1036,-663,20.1,1659.9,9,3,0,4,7,1,0,0,0,0,15563,6.8,17386,251,52,-1036,663,25.1,1556.3
4506187431,1,18,0,0,3,3,2,0,0,0,0,16639,7.2,19375,269,64,835,1506,26.9,1663.9,36,5,1,3,3,4,1,1,0,0,15804,7.0,17869,216,56,-835,-1506,21.6,1580.4
4506682192,0,11,2,0,3,6,1,0,0,0,0,13899,6.4,16444,202,36,-3238,-2465,20.2,1389.9,14,4,1,6,3,7,1,1,0,0,17137,7.2,18909,261,45,3238,2465,26.1,1713.7
4520873803,1,15,1,0,3,7,5,1,0,1,1,16886,7.0,17965,244,53,75,616,24.4,1688.6,18,0,1,7,3,14,1,1,0,0,16811,7.0,17349,195,60,-75,-616,19.5,1681.1
4522260081,0,14,1,0,9,8,7,1,1,0,0,17183,7.0,18225,196,60,-1295,-305,19.6,1718.3,18,1,1,8,9,10,0,0,0,0,18478,7.0,18530,247,56,1295,305,24.7,1847.8
4452102075,1,59,2,1,5,2,8,1,1,0,0,17010,7.0,18660,250,58,2312,1175,25.0,1701.0,34,3,0,2,5,2,0,0,0,0,14698,6.6,17485,220,54,-2312,-1175,22.0,1469.8
4508629003,0,16,2,1,7,9,5,2,1,1,0,16806,7.0,18034,228,48,-256,-1580,22.8,1680.6,34,2,0,9,7,7,0,0,0,0,17062,7.4,19614,230,52,256,1580,23.0,1706.2
4434622213,1,14,0,1,14,8,15,1,0,1,0,19372,7.0,18802,180,62,1342,13,18.0,1937.2,11,2,0,8,14,9,0,0,0,0,18030,7.4,18789,229,51,-1342,-13,22.9,1803.0
4510536402,0,48,4,0,1,6,2,0,0,0,0,13653,6.6,16539,220,52,-3728,-3076,22.0,1365.3,14,1,1,6,1,4,0,0,0,0,17381,7.4,19615,220,64,3728,3076,22.0,1738.1
4513346421,1,16,4,0,5,9,4,0,0,0,0,15999,6.8,17524,203,62,-1189,-1741,20.3,1599.9,16,4,1,9,5,5,1,1,0,0,17188,7.2,19265,224,50,1189,1741,22.4,1718.8
4478754286,0,16,2,0,8,15,9,1,1,0,0,15797,6.2,15229,168,34,-4801,-5205,16.8,1579.7,16,5,1,15,8,14,0,0,0,0,20598,7.4,20434,219,50,4801,5205,21.9,2059.8
4518737622,0,29,5,1,4,3,7,0,0,0,0,15517,6.6,16917,231,35,653,-556,23.1,1551.7,15,2,0,3,4,1,1,1,0,0,14864,6.6,17473,226,48,-653,556,22.6,1486.4
4502908431,0,58,2,0,10,9,19,1,1,0,0,17583,7.0,17639,201,48,-236,-1078,20.1,1758.3,23,2,1,9,10,13,0,0,0,0,17819,7.2,18717,225,60,236,1078,22.5,1781.9
4523555451,1,41,1,1,10,6,10,0,0,0,0,18688,7.2,18613,218,47,3424,3153,21.8,1868.8,15,2,0,6,10,7,0,0,0,0,15264,6.2,15460,170,40,-3424,-3153,17.0,1526.4
4462529490,0,16,4,0,11,13,13,1,1,0,0,18549,6.8,16837,182,56,-1048,-450,18.2,1854.9,15,4,1,13,11,17,1,0,1,1,19597,6.8,17287,201,40,1048,450,20.1,1959.7
4435875824,0,17,2,0,8,10,9,0,0,0,0,16738,6.8,17657,199,48,-1428,-671,19.9,1673.8,15,5,1,10,8,16,1,1,0,0,18166,7.0,18328,201,52,1428,671,20.1,1816.6
4512258772,0,18,4,1,8,1,6,1,0,1,0,18607,7.4,20228,264,53,4488,3191,26.4,1860.7,15,1,0,1,8,1,1,1,0,0,14119,6.6,17037,210,60,-4488,-3191,21.0,1411.9
4524920095,0,22,2,0,1,9,1,0,0,0,0,13802,6.2,15859,216,56,-3276,-2790,21.6,1380.2,142,5,1,9,1,9,1,1,0,0,17078,7.0,18649,217,47,3276,2790,21.7,1707.8
4521167934,1,16,2,1,6,3,3,0,0,0,0,16454,7.0,18902,228,63,1510,1545,22.8,1645.4,13,0,0,3,6,2,1,1,0,0,14944,7.0,17357,222,60,-1510,-1545,22.2,1494.4
4510662629,1,18,2,1,10,4,7,1,1,0,0,18089,7.0,19431,235,43,2696,2452,23.5,1808.9,11,1,0,4,10,4,0,0,0,0,15393,6.6,16979,196,51,-2696,-2452,19.6,1539.3
4513797565,1,16,1,1,11,5,10,1,1,0,0,19245,7.6,20286,245,60,3108,2974,24.5,1924.5,58,2,0,5,11,6,0,0,0,0,16137,6.8,17312,194,64,-3108,-2974,19.4,1613.7
4521835060,1,42,3,0,8,13,8,0,0,0,0,17639,6.6,16561,194,48,-887,-501,19.4,1763.9,51,5,1,13,8,20,1,1,0,0,18526,6.8,17062,198,36,887,501,19.8,1852.6
4527433973,0,15,3,0,2,7,3,0,0,0,0,15268,6.8,17717,214,72,-880,179,21.4,1526.8,18,0,1,7,2,8,0,0,0,0,16148,6.6,17538,198,42,880,-179,19.8,1614.8
4510743297,0,39,6,1,9,6,7,0,0,0,0,18466,7.6,19801,218,68,2220,2300,21.8,1846.6,11,2,0,6,9,7,1,1,0,0,16246,7.0,17501,185,52,-2220,-2300,18.5,1624.6
4522690017,0,17,4,1,5,9,5,0,0,0,0,14819,6.4,15937,183,46,-3477,-3301,18.3,1481.9,41,5,0,9,5,7,1,1,0,0,18296,7.2,19238,227,58,3477,3301,22.7,1829.6
4462423061,0,14,1,1,7,12,5,0,0,0,0,16125,6.8,17377,196,40,-3290,-2697,19.6,1612.5,17,1,0,12,7,14,0,0,0,0,19415,7.2,20074,231,47,3290,2697,23.1,1941.5
4464723011,1,12,2,1,10,6,5,0,0,0,0,17142,7.0,18615,221,45,2121,1813,22.1,1714.2,16,0,0,6,10,3,0,0,0,0,15021,6.4,16802,200,31,-2121,-1813,20.0,1502.1
4475365709,1,18,0,0,5,3,6,1,1,0,0,15899,7.0,18161,225,42,698,101,22.5,1589.9,36,5,1,3,5,2,0,0,0,0,15201,7.0,18060,221,59,-698,-101,22.1,1520.1
4489065955,1,15,1,0,4,12,8,0,0,0,0,15147,6.4,16605,188,50,-4559,-1851,18.8,1514.7,18,3,1,12,4,22,1,1,0,0,19706,7.2,18456,241,44,4559,1851,24.1,1970.6
4461203281,0,17,3,0,1,9,2,0,0,0,0,13570,6.2,15620,194,52,-6578,-4807,19.4,1357.0,21,3,1,9,1,8,2,1,1,1,20148,7.2,20427,267,63,6578,4807,26.7,2014.8
4450617242,0,13,1,0,4,5,5,0,0,0,0,14459,6.8,17799,173,49,-2859,143,17.3,1445.9,13,1,1,5,4,8,0,0,0,0,17318,7.0,17656,242,46,2859,-143,24.2,1731.8
4505237084,0,15,2,1,5,4,4,0,0,0,0,15742,6.8,17504,219,55,501,642,21.9,1574.2,13,1,0,4,5,5,1,1,0,0,15241,6.6,16862,196,52,-501,-642,19.6,1524.1
4463393094,0,12,2,0,5,7,3,0,0,0,0,16206,7.0,17906,229,53,-33,1233,22.9,1620.6,14,3,1,7,5,8,1,1,0,0,16239,6.6,16673,200,40,33,-1233,20.0,1623.9
4524545264,0,24,3,0,3,10,2,0,0,0,0,14796,6.4,16448,204,53,-3385,-2980,20.4,1479.6,15,3,1,10,3,10,2,1,1,0,18181,7.4,19428,223,56,3385,2980,22.3,1818.1
4467033955,1,15,5,1,8,4,7,1,0,1,0,18837,7.6,20066,246,48,3479,2657,24.6,1883.7,54,4,0,4,8,6,1,1,0,0,15358,6.8,17409,222,55,-3479,-2657,22.2,1535.8
4525135236,1,13,3,0,3,6,3,1,0,1,0,15742,7.0,18244,220,64,-873,-1792,22.0,1574.2,16,4,1,6,3,6,0,0,0,0,16615,7.4,20036,215,62,873,1792,21.5,1661.5
4500426573,0,17,3,0,3,8,3,0,0,0,0,15015,6.8,17386,216,60,-2327,-2301,21.6,1501.5,75,3,1,8,3,8,1,0,1,0,17342,7.2,19687,230,52,2327,2301,23.0,1734.2
4440425565,1,16,2,0,13,6,13,2,1,1,2,22162,7.8,21254,249,72,6578,5388,24.9,2216.2,10,2,1,6,13,7,0,0,0,0,15584,6.2,15866,156,68,-6578,-5388,15.6,1558.4
4520894516,0,38,4,1,5,7,4,0,0,0,0,16562,7.2,18781,210,64,44,170,21.0,1656.2,21,1,0,7,5,8,1,1,0,0,16518,7.0,18611,245,36,-44,-170,24.5,1651.8
4494785966,1,14,3,0,4,6,7,1,0,1,0,16685,7.0,18643,236,71,289,-201,23.6,1668.5,18,2,1,6,4,4,1,1,0,0,16396,7.0,18844,234,52,-289,201,23.4,1639.6
4467040856,1,14,4,1,6,2,4,0,0,0,0,16636,7.2,18741,225,40,1833,899,22.5,1663.6,16,0,0,2,6,3,1,1,0,0,14803,6.8,17842,201,63,-1833,-899,20.1,1480.3
4524685045,1,12,3,0,8,6,9,1,1,0,0,16738,7.2,19296,214,60,624,1208,21.4,1673.8,14,0,1,6,8,3,0,0,0,0,16114,7.0,18088,225,33,-624,-1208,22.5,1611.4
4475690414,0,13,4,0,7,9,4,1,0,1,0,16360,6.6,16891,187,52,-833,-773,18.7,1636.0,19,2,1,9,7,13,1,1,0,0,17193,6.8,17664,197,56,833,773,19.7,1719.3
4384241438,1,16,1,0,7,3,7,1,1,0,0,16355,7.0,18991,238,43,1143,1251,23.8,1635.5,11,0,1,3,7,2,0,0,0,0,15212,7.0,17740,216,59,-1143,-1251,21.6,1521.2
4521318452,1,17,0,0,9,8,8,1,0,1,0,17657,7.2,19166,227,56,545,1033,22.7,1765.7,14,2,1,8,9,9,1,1,0,0,17112,7.0,18133,198,40,-545,-1033,19.8,1711.2
4515736487,0,21,3,0,4,8,3,0,0,0,0,14787,6.6,16543,185,60,-2404,-2013,18.5,1478.7,18,2,1,8,4,8,0,0,0,0,17191,7.0,18556,228,36,2404,2013,22.8,1719.1
4527354492,1,15,7,0,5,6,3,0,0,0,0,15678,6.8,17696,211,51,-596,774,21.1,1567.8,19,3,1,6,5,9,0,0,0,0,16274,6.8,16922,223,32,596,-774,22.3,1627.4
4508253654,1,19,2,1,11,4,6,0,0,0,0,17702,7.2,18597,216,30,1741,675,21.6,1770.2,15,4,0,4,11,2,0,0,0,0,15961,6.8,17922,211,63,-1741,-675,21.1,1596.1
4474906958,1,17,5,0,6,7,10,1,0,1,0,16027,6.6,16856,212,44,-177,-113,21.2,1602.7,16,5,1,7,6,8,1,1,0,0,16204,6.4,16969,183,48,177,113,18.3,1620.4
4495292630,1,13,4,1,3,7,4,1,0,1,0,15088,6.6,16413,209,44,-1685,-2902,20.9,1508.8,19,4,0,7,3,6,0,0,0,0,16773,7.4,19315,235,55,1685,2902,23.5,1677.3
4517670386,0,43,3,0,1,14,1,0,0,0,0,13172,6.0,14988,187,28,-7079,-4936,18.7,1317.2,15,5,1,14,1,21,1,1,0,0,20251,7.4,19924,222,63,7079,4936,22.2,2025.1
4523881390,1,18,2,1,6,2,8,1,0,1,0,17779,7.6,20127,268,48,3206,2261,26.8,1777.9,15,4,0,2,6,2,0,0,0,0,14573,7.0,17866,225,52,-3206,-2261,22.5,1457.3
4502735326,1,16,1,1,7,6,7,0,0,0,0,16672,7.0,18698,210,58,-521,860,21.0,1667.2,13,4,0,6,7,11,1,1,0,0,17193,7.0,17838,250,48,521,-860,25.0,1719.3
4522686444,0,16,1,1,6,5,4,0,0,0,0,16682,7.0,18272,236,52,598,374,23.6,1668.2,14,4,0,5,6,5,1,1,0,0,16084,6.8,17898,235,60,-598,-374,23.5,1608.4
4527598275,0,54,3,0,7,8,10,0,0,0,0,16238,6.8,17694,202,50,-982,1441,20.2,1623.8,11,4,1,8,7,10,1,1,0,0,17220,6.6,16253,185,64,982,-1441,18.5,1722.0
4525067296,1,12,0,1,3,7,2,0,0,0,0,14788,6.6,17345,215,48,-2025,-2448,21.5,1478.8,17,3,0,7,3,6,1,1,0,0,16813,7.2,19793,233,65,2025,2448,23.3,1681.3
4500263311,0,103,1,0,2,5,0,1,1,0,0,13649,6.8,17258,199,52,-2497,-1239,19.9,1364.9,13,3,1,5,2,4,0,0,0,0,16146,7.0,18497,211,60,2497,1239,21.1,1614.6
4522201700,1,17,1,0,4,4,3,0,0,0,0,15688,6.8,18341,237,51,91,591,23.7,1568.8,21,5,1,4,4,6,0,0,0,0,15597,6.8,17750,239,54,-91,-591,23.9,1559.7
4520800745,1,16,1,0,6,10,6,1,1,0,0,15936,6.6,17184,233,36,-2542,-1008,23.3,1593.6,17,2,1,10,6,9,0,0,0,0,18478,7.0,18192,233,52,2542,1008,23.3,1847.8
4463540440,0,34,2,1,5,8,3,0,0,0,0,16422,7.0,18934,247,52,-509,-196,24.7,1642.2,15,1,0,8,5,8,1,1,0,0,16931,6.8,19130,218,48,509,196,21.8,1693.1
4527238809,0,14,3,1,5,8,6,0,0,0,0,14557,6.4,15691,169,52,-3666,-2993,16.9,1455.7,17,2,0,8,5,8,0,0,0,0,18223,7.2,18684,235,52,3666,2993,23.5,1822.3
4500291945,1,16,0,1,7,3,10,1,1,0,0,17546,6.8,17209,228,47,1493,1167,22.8,1754.6,10,2,0,3,7,4,1,0,1,1,16053,6.4,16042,193,51,-1493,-1167,19.3,1605.3
4525936315,1,54,4,1,7,9,6,1,1,0,0,16437,6.8,16958,195,48,-222,17,19.5,1643.7,18,6,0,9,7,12,0,0,0,0,16659,6.8,16941,208,34,222,-17,20.8,1665.9
4506337812,1,41,1,1,7,3,6,1,1,0,0,18195,7.4,20319,252,64,4197,3107,25.2,1819.5,14,3,0,3,7,1,1,0,1,0,13998,6.8,17212,187,53,-4197,-3107,18.7,1399.8
4489899716,1,14,9,1,8,4,6,1,0,1,0,17187,7.0,18382,232,39,1546,61,23.2,1718.7,23,4,0,4,8,3,0,0,0,0,15641,7.2,18321,240,55,-1546,-61,24.0,1564.1
4502871772,1,14,0,1,3,7,1,0,0,0,0,14735,7.0,18050,213,64,-2483,-1356,21.3,1473.5,15,1,0,7,3,10,1,1,0,0,17218,7.4,19406,228,62,2483,1356,22.8,1721.8
4523395238,1,23,5,1,9,2,8,1,1,0,0,17194,7.4,19161,221,40,2410,1034,22.1,1719.4,12,2,0,2,9,0,0,0,0,0,14784,6.8,18127,235,55,-2410,-1034,23.5,1478.4
4519835303,0,14,3,0,0,5,0,0,0,0,0,13094,6.4,15865,205,44,-3915,-4094,20.5,1309.4,41,4,1,5,0,2,1,1,0,0,17009,7.4,19959,259,73,3915,4094,25.9,1700.9
4515360430,1,15,1,1,5,3,2,2,1,1,0,16243,7.4,19006,245,59,855,2880,24.5,1624.3,17,3,0,3,5,4,0,0,0,0,15388,6.4,16126,204,50,-855,-2880,20.4,1538.8
4527457700,1,12,5,1,8,4,11,1,1,0,0,18320,7.0,18926,244,56,3461,1985,24.4,1832.0,20,3,0,4,8,2,0,0,0,0,14859,6.6,16941,217,36,-3461,-1985,21.7,1485.9
4525357856,1,53,2,1,4,5,4,0,0,0,0,15232,7.0,17793,209,51,-625,-945,20.9,1523.2,11,1,0,5,4,6,0,0,0,0,15857,7.2,18738,215,50,625,945,21.5,1585.7
4497473518,0,14,3,0,8,7,7,2,1,1,0,17996,7.0,18896,208,64,1295,435,20.8,1799.6,41,4,1,7,8,5,0,0,0,0,16701,7.0,18461,227,52,-1295,-435,22.7,1670.1
4513514281,0,11,2,0,6,9,7,0,0,0,0,16522,6.8,17675,223,44,-1128,-2710,22.3,1652.2,18,2,1,9,6,4,1,1,0,0,17650,7.4,20385,224,72,1128,2710,22.4,1765.0
4527400010,1,15,1,0,7,5,10,0,0,0,0,16271,7.0,17500,218,40,787,846,21.8,1627.1,15,1,1,5,7,4,1,1,0,0,15484,6.8,16654,208,46,-787,-846,20.8,1548.4
4424206558,1,17,1,1,7,8,10,1,1,0,0,16863,6.6,17727,216,48,106,-462,21.6,1686.3,14,0,0,8,7,9,0,0,0,0,16757,7.2,18189,184,52,-106,462,18.4,1675.7
4432359708,1,12,6,0,2,5,1,0,0,0,0,13860,6.6,16835,193,52,-2807,-1537,19.3,1386.0,90,5,1,5,2,6,0,0,0,0,16667,6.8,18372,249,42,2807,1537,24.9,1666.7
4521989162,1,19,3,1,4,9,3,1,1,0,0,16289,6.8,17304,223,67,-1764,-1997,22.3,1628.9,17,2,0,9,4,11,0,0,0,0,18053,7.2,19301,244,51,1764,1997,24.4,1805.3
4487385988,1,56,2,0,6,2,9,1,1,0,0,16751,7.0,18674,239,42,832,551,23.9,1675.1,17,2,1,2,6,2,0,0,0,0,15919,6.8,18123,225,69,-832,-551,22.5,1591.9
4477952822,1,19,1,0,4,2,4,0,0,0,0,15205,6.8,17501,234,44,457,690,23.4,1520.5,18,2,1,2,4,2,1,1,0,0,14748,6.6,16811,250,45,-457,-690,25.0,1474.8
4523038174,0,14,1,1,2,12,3,0,0,0,0,13126,6.0,14222,175,46,-4394,-3817,17.5,1312.6,12,4,0,12,2,11,1,1,0,0,17520,7.0,18039,195,44,4394,3817,19.5,1752.0
4517001678,0,13,3,0,6,12,5,1,1,0,0,15716,6.8,17135,189,46,-3393,-1177,18.9,1571.6,14,3,1,12,6,19,0,0,0,0,19109,6.8,18312,206,44,3393,1177,20.6,1910.9
4505307600,1,19,6,1,5,9,5,0,0,0,0,14630,6.6,16527,177,28,-2167,-2045,17.7,1463.0,18,4,0,9,5,10,1,1,0,0,16797,7.0,18572,214,41,2167,2045,21.4,1679.7
4514011142,0,8,0,1,7,10,7,1,0,1,1,16859,7.0,17173,198,47,-2416,-2252,19.8,1685.9,12,2,0,10,7,12,1,1,0,1,19275,7.4,19425,221,39,2416,2252,22.1,1927.5
4526939278,0,15,3,0,8,8,8,0,0,0,0,16488,6.8,17583,217,47,-451,-1201,21.7,1648.8,13,3,1,8,8,4,0,0,0,0,16939,7.0,18784,196,69,451,1201,19.6,1693.9
4518920313,0,16,0,0,5,12,8,1,1,0,0,15376,6.6,16791,206,41,-4864,-3336,20.6,1537.6,66,4,1,12,5,11,0,0,0,0,20240,7.6,20127,247,48,4864,3336,24.7,2024.0
4510728488,1,18,2,1,6,4,4,1,1,0,0,17277,7.2,19610,229,54,1687,1089,22.9,1727.7,36,3,0,4,6,5,1,0,1,0,15590,7.2,18521,232,56,-1687,-1089,23.2,1559.0
4451378349,0,14,0,0,9,15,7,0,0,0,0,17492,7.2,19413,189,60,-1988,-616,18.9,1749.2,51,2,1,15,9,17,2,1,1,0,19480,7.4,20029,204,56,1988,616,20.4,1948.0
4520994521,0,37,5,0,2,7,3,0,0,0,0,14933,7.2,18353,213,52,-1957,-354,21.3,1493.3,20,2,1,7,2,4,2,1,1,0,16890,7.0,18707,220,60,1957,354,22.0,1689.0
4524780505,1,18,3,1,6,2,6,1,1,0,0,16868,6.8,18060,245,52,1982,990,24.5,1686.8,16,2,0,2,6,6,0,0,0,0,14886,6.8,17070,227,60,-1982,-990,22.7,1488.6
4516106075,0,14,4,0,3,16,5,1,0,1,0,14511,6.2,14800,158,59,-6887,-5573,15.8,1451.1,38,2,1,16,3,19,1,1,0,0,21398,7.4,20373,248,57,6887,5573,24.8,2139.8
4523735052,0,15,2,0,3,8,2,0,0,0,0,14478,6.6,16879,205,44,-2153,-2381,20.5,1447.8,88,0,1,8,3,8,2,1,1,0,16631,7.2,19260,215,52,2153,2381,21.5,1663.1
4518971056,0,29,2,1,5,2,5,0,0,0,0,16142,7.2,18818,245,49,534,634,24.5,1614.2,15,4,0,2,5,2,2,1,1,0,15608,6.8,18184,277,58,-534,-634,27.7,1560.8
4510540310,1,68,3,0,7,3,7,1,0,1,0,16498,7.2,18955,219,60,468,2091,21.9,1649.8,178,2,1,3,7,4,0,0,0,0,16030,6.6,16864,237,64,-468,-2091,23.7,1603.0
4477353285,1,14,1,1,5,2,1,0,0,0,0,15510,7.0,17649,203,48,1215,1170,20.3,1551.0,13,0,0,2,5,2,1,1,0,0,14295,6.6,16479,244,48,-1215,-1170,24.4,1429.5
4491631842,1,31,5,1,4,4,4,1,1,0,0,16095,7.0,18669,241,65,-262,-375,24.1,1609.5,24,3,0,4,4,2,0,0,0,0,16357,7.2,19044,257,55,262,375,25.7,1635.7
4442002416,1,18,3,0,5,2,3,0,0,0,0,16337,7.2,19371,259,48,1795,1933,25.9,1633.7,15,6,1,2,5,2,0,0,0,0,14542,6.8,17438,238,48,-1795,-1933,23.8,1454.2
4517836612,1,14,4,1,8,5,8,1,1,0,0,18021,7.2,19358,253,52,1790,1764,25.3,1802.1,25,1,0,5,8,4,0,0,0,0,16231,7.0,17594,237,47,-1790,-1764,23.7,1623.1
4479146684,0,14,4,0,4,11,3,0,0,0,0,14493,6.6,15935,210,39,-4130,-2849,21.0,1449.3,19,2,1,11,4,14,1,1,0,0,18623,7.0,18784,226,36,4130,2849,22.6,1862.3
4475685776,1,15,2,1,6,1,9,0,0,0,0,17357,7.4,20069,236,56,2030,1411,23.6,1735.7,18,1,0,1,6,2,0,0,0,0,15327,7.0,18658,252,69,-2030,-1411,25.2,1532.7
4525788631,0,16,5,1,6,12,8,1,1,0,0,16039,6.6,16635,198,36,-2088,-2153,19.8,1603.9,27,6,0,12,6,15,0,0,0,0,18127,7.0,18788,201,48,2088,2153,20.1,1812.7
4500976861,1,34,5,0,2,7,2,0,0,0,0,15356,7.0,17995,230,60,-1706,-1004,23.0,1535.6,20,3,1,7,2,7,1,1,0,0,17062,7.0,18999,209,71,1706,1004,20.9,1706.2
4520336674,1,19,7,0,10,4,13,1,1,0,0,18401,7.6,20273,236,60,3668,4509,23.6,1840.1,118,2,1,4,10,3,1,0,1,0,14733,6.6,15764,195,46,-3668,-4509,19.5,1473.3
4484419381,0,12,2,0,7,5,7,0,0,0,0,17235,7.4,19413,251,48,750,867,25.1,1723.5,12,0,1,5,7,8,0,0,0,0,16485,7.2,18546,230,60,-750,-867,23.0,1648.5
4496662443,1,15,4,0,5,6,9,2,1,1,1,17450,6.6,17226,226,53,555,-1022,22.6,1745.0,19,3,1,6,5,12,0,0,0,0,16895,7.0,18248,232,50,-555,1022,23.2,1689.5
4500460530,1,23,1,1,9,2,12,1,1,0,0,17913,7.4,19102,218,53,3453,1775,21.8,1791.3,10,0,0,2,9,2,0,0,0,0,14460,6.8,17327,215,57,-3453,-1775,21.5,1446.0
4499463282,0,17,3,0,5,8,6,2,1,1,0,15494,6.4,16228,187,59,-3528,-2277,18.7,1549.4,16,4,1,8,5,8,0,0,0,0,19022,7.0,18505,260,44,3528,2277,26.0,1902.2
4505511340,0,16,6,1,10,9,10,0,0,0,0,17818,6.8,17651,204,41,-1272,-1634,20.4,1781.8,45,9,0,9,10,9,0,0,0,0,19090,7.2,19285,258,36,1272,1634,25.8,1909.0
4513354940,1,23,4,1,7,5,6,1,1,0,0,16946,6.8,17723,247,40,2276,1630,24.7,1694.6,15,6,0,5,7,7,0,0,0,0,14670,6.4,16093,194,29,-2276,-1630,19.4,1467.0
4513473008,1,44,5,0,5,2,7,1,1,0,0,17126,6.8,17880,248,53,1936,448,24.8,1712.6,16,4,1,2,5,2,0,0,0,0,15190,6.8,17432,230,71,-1936,-448,23.0,1519.0
4448434808,1,13,1,0,10,3,11,1,1,0,0,17793,7.6,19766,208,55,1988,1552,20.8,1779.3,15,2,1,3,10,2,0,0,0,0,15805,7.0,18214,217,53,-1988,-1552,21.7,1580.5
4525167024,1,21,4,0,8,7,9,0,0,0,0,17737,7.2,18303,193,50,1083,451,19.3,1773.7,16,4,1,7,8,2,0,0,0,0,16654,7.2,17852,207,44,-1083,-451,20.7,1665.4
4514309689,1,12,1,0,5,9,5,0,0,0,0,15400,7.0,17541,215,40,-4112,-2493,21.5,1540.0,16,1,1,9,5,9,0,0,0,0,19512,7.4,20034,219,72,4112,2493,21.9,1951.2
4459832099,1,18,1,1,9,3,6,2,1,1,0,19155,7.6,20750,251,88,4526,2759,25.1,1915.5,14,4,0,3,9,3,0,0,0,0,14629,7.0,17991,192,48,-4526,-2759,19.2,1462.9
4497740999,1,22,6,0,8,4,12,1,1,0,0,18232,7.2,18215,228,52,2655,2106,22.8,1823.2,17,4,1,4,8,3,0,0,0,0,15577,6.4,16109,226,36,-2655,-2106,22.6,1557.7
4499336930,0,16,3,1,5,8,6,0,0,0,0,16979,7.2,19193,247,56,-988,-797,24.7,1697.9,12,1,0,8,5,6,1,1,0,0,17967,7.4,19990,219,63,988,797,21.9,1796.7
4494766750,1,68,2,1,9,3,16,0,0,0,0,17718,7.0,18091,209,48,3017,1450,20.9,1771.8,17,2,0,3,9,2,0,0,0,0,14701,6.8,16641,197,52,-3017,-1450,19.7,1470.1
4511146118,1,76,3,1,6,4,9,1,1,0,0,17620,7.0,19434,233,64,2387,1411,23.3,1762.0,18,1,0,4,6,7,0,0,0,0,15233,6.8,18023,201,67,-2387,-1411,20.1,1523.3
4442091575,1,20,3,1,11,1,13,1,1,0,1,18789,7.4,20433,231,38,4250,3916,23.1,1878.9,17,0,0,1,11,1,0,0,0,0,14539,6.4,16517,223,57,-4250,-3916,22.3,1453.9
4509259241,1,10,1,1,7,5,4,1,0,1,2,19036,7.0,18857,246,47,4363,4467,24.6,1903.6,11,1,0,5,7,4,0,0,0,0,14673,5.8,14390,164,28,-4363,-4467,16.4,1467.3
4521542969,1,13,3,1,6,4,10,2,1,1,0,17086,7.0,17746,229,54,1838,-689,22.9,1708.6,14,3,0,4,6,7,0,0,0,0,15248,7.2,18435,231,51,-1838,689,23.1,1524.8
4494913568,0,16,3,1,7,11,11,0,0,0,0,17037,7.0,18710,243,47,-1896,-1756,24.3,1703.7,15,2,0,11,7,13,1,1,0,0,18933,7.4,20466,243,50,1896,1756,24.3,1893.3
4484592953,1,29,1,1,7,4,6,0,0,0,0,17028,7.4,19169,247,52,1586,2622,24.7,1702.8,17,1,0,4,7,4,1,1,0,0,15442,6.6,16547,214,55,-1586,-2622,21.4,1544.2
4515526880,0,32,4,0,3,10,3,0,0,0,0,15067,6.6,15937,186,39,-2968,-3336,18.6,1506.7,21,1,1,10,3,11,1,1,0,0,18035,7.4,19273,214,57,2968,3336,21.4,1803.5
4520801995,0,17,2,0,2,10,1,0,0,0,0,15239,7.0,18073,232,52,-3449,-1995,23.2,1523.9,17,0,1,10,2,13,1,1,0,0,18688,7.6,20068,231,57,3449,1995,23.1,1868.8
4516861860,1,16,5,1,4,3,4,0,0,0,0,16313,6.8,17824,240,47,1128,498,24.0,1631.3,28,3,0,3,4,5,0,0,0,0,15185,6.8,17326,220,41,-1128,-498,22.0,1518.5
4524447311,0,16,3,0,2,9,1,0,0,0,0,15218,6.8,17342,227,51,-2789,-1511,22.7,1521.8,14,5,1,9,2,7,1,1,0,0,18007,7.0,18853,248,56,2789,1511,24.8,1800.7
4490257266,0,13,0,1,6,9,5,1,1,0,0,15550,6.8,17134,191,44,-1467,-1916,19.1,1555.0,15,2,0,9,6,5,0,0,0,0,17017,7.2,19050,213,40,1467,1916,21.3,1701.7
4495200388,0,16,2,0,3,6,2,0,0,0,0,13489,6.0,14875,192,20,-2345,-2959,19.2,1348.9,19,2,1,6,3,5,1,1,0,0,15834,6.8,17834,198,60,2345,2959,19.8,1583.4
4465357470,0,19,2,0,5,6,3,0,0,0,0,15722,6.8,17153,224,40,-488,-98,22.4,1572.2,16,3,1,6,5,7,1,1,0,0,16210,6.8,17251,192,48,488,98,19.2,1621.0
4449098709,1,13,1,1,11,1,10,1,1,0,1,19673,7.6,21261,209,68,5797,4456,20.9,1967.3,13,0,0,1,11,0,0,0,0,0,13876,6.8,16805,218,56,-5797,-4456,21.8,1387.6
4526903183,0,85,2,0,6,9,7,0,0,0,0,16223,6.8,17056,196,36,-605,-782,19.6,1622.3,13,2,1,9,6,7,1,1,0,0,16828,7.0,17838,203,56,605,782,20.3,1682.8
4508188294,0,13,1,0,1,10,1,0,0,0,0,13340,6.2,15466,223,32,-3586,-2271,22.3,1334.0,37,1,1,10,1,16,1,1,0,0,16926,6.8,17737,189,32,3586,2271,18.9,1692.6
4525542584,0,14,1,1,5,3,2,1,0,1,0,15358,6.6,17220,223,40,543,-624,22.3,1535.8,11,2,0,3,5,3,1,1,0,0,14815,7.0,17844,199,67,-543,624,19.9,1481.5
4525207447,1,49,4,0,4,3,6,0,0,0,0,15091,7.2,18237,215,39,-1516,-441,21.5,1509.1,16,7,1,3,4,3,1,1,0,0,16607,7.0,18678,267,54,1516,441,26.7,1660.7
4525016329,0,38,2,0,5,10,6,0,0,0,0,15141,6.8,17635,176,48,-3274,-1385,17.6,1514.1,12,15,1,10,5,8,1,1,0,0,18415,7.2,19020,238,36,3274,1385,23.8,1841.5
4484826568,0,14,2,0,5,9,3,1,1,0,0,15908,6.8,16828,211,44,-2080,-1117,21.1,1590.8,17,4,1,9,5,10,0,0,0,0,17988,7.0,17945,247,44,2080,1117,24.7,1798.8
4437014946,0,14,2,1,3,2,3,0,0,0,0,15734,7.0,18750,236,68,465,-911,23.6,1573.4,82,3,0,2,3,1,1,1,0,0,15269,7.2,19661,226,76,-465,911,22.6,1526.9
4517908565,1,14,2,1,12,3,13,1,1,0,0,19626,7.6,20682,228,68,4400,3092,22.8,1962.6,13,3,0,3,12,2,0,0,0,0,15226,6.6,17590,223,48,-4400,-3092,22.3,1522.6
4461035209,0,18,1,1,7,9,7,0,0,0,0,15946,6.8,16836,170,36,-833,-932,17.0,1594.6,16,2,0,9,7,10,1,0,1,0,16779,7.0,17768,230,44,833,932,23.0,1677.9
4447490163,0,18,3,1,4,8,3,0,0,0,0,15043,6.6,16533,207,34,-2816,-2760,20.7,1504.3,16,5,0,8,4,10,1,1,0,0,17859,7.2,19293,232,57,2816,2760,23.2,1785.9
4523042890,1,15,3,1,5,6,4,0,0,0,0,17024,7.2,19195,254,63,901,1182,25.4,1702.4,12,2,0,6,5,7,0,0,0,0,16123,6.8,18013,214,48,-901,-1182,21.4,1612.3
4494315859,1,11,3,0,9,4,14,0,0,0,0,18587,7.4,19265,223,52,2851,1140,22.3,1858.7,17,2,1,4,9,3,1,1,0,0,15736,6.8,18125,226,68,-2851,-1140,22.6,1573.6
4521738539,1,15,4,1,16,6,16,0,0,0,0,21442,7.6,20440,232,48,5956,4568,23.2,2144.2,18,0,0,6,16,5,0,0,0,0,15486,6.4,15872,185,40,-5956,-4568,18.5,1548.6
4457626899,1,18,3,1,4,8,4,1,0,1,0,16657,7.0,18154,210,58,-206,-1476,21.0,1665.7,17,6,0,8,4,0,1,1,0,0,16863,7.2,19630,248,52,206,1476,24.8,1686.3
4523024529,0,38,2,0,6,10,8,0,0,0,0,16530,7.0,18808,205,54,-1726,-267,20.5,1653.0,20,3,1,10,6,12,1,1,0,0,18256,7.0,19075,238,46,1726,267,23.8,1825.6
4508099028,1,13,2,0,1,6,2,0,0,0,0,14168,6.6,16884,217,56,-3344,-2671,21.7,1416.8,18,3,1,6,1,7,2,1,1,0,17512,7.6,19555,225,77,3344,2671,22.5,1751.2
4525305174,1,17,3,1,5,8,6,0,0,0,0,15754,6.8,16911,196,44,-1157,-573,19.6,1575.4,20,7,0,8,5,12,1,1,0,0,16911,6.6,17484,228,48,1157,573,22.8,1691.1
4518463006,0,40,3,0,10,8,10,0,0,0,0,17546,7.2,18498,191,44,510,921,19.1,1754.6,14,2,1,8,10,7,1,1,0,0,17036,7.0,17577,217,51,-510,-921,21.7,1703.6
4519862589,1,16,2,1,10,6,12,1,0,1,0,18692,7.4,19767,248,48,2830,1589,24.8,1869.2,12,2,0,6,10,4,0,0,0,0,15862,6.8,18178,210,39,-2830,-1589,21.0,1586.2
4524923771,1,20,6,1,9,2,10,0,0,0,0,17855,7.2,18853,211,60,4076,2996,21.1,1785.5,44,2,0,2,9,1,1,1,0,0,13779,6.6,15857,211,44,-4076,-2996,21.1,1377.9
4525051102,1,10,3,1,3,4,3,0,0,0,0,15482,6.8,17584,243,47,36,-928,24.3,1548.2,19,2,0,4,3,1,2,1,1,0,15446,7.2,18512,226,67,-36,928,22.6,1544.6
4524397696,0,14,2,0,3,10,1,0,0,0,0,15827,7.0,17607,245,56,-2683,-2383,24.5,1582.7,20,3,1,10,3,12,1,1,0,0,18510,7.2,19990,234,59,2683,2383,23.4,1851.0
4508091967,0,17,1,0,2,8,1,0,0,0,0,14467,6.6,16928,215,48,-3794,-1962,21.5,1446.7,16,2,1,8,2,11,1,1,0,0,18261,7.2,18890,234,76,3794,1962,23.4,1826.1
4470106010,0,19,3,0,6,5,4,1,1,0,0,16000,7.2,18965,181,79,230,1894,18.1,1600.0,14,3,1,5,6,4,0,0,0,0,15770,6.8,17071,236,36,-230,-1894,23.6,1577.0
4527399718,0,15,0,0,1,6,1,0,0,0,0,14417,7.0,17488,237,61,-2984,-1466,23.7,1441.7,13,1,1,6,1,10,1,1,0,0,17401,7.0,18954,248,54,2984,1466,24.8,1740.1
4525231930,0,16,3,1,2,4,2,0,0,0,0,14584,6.6,16647,235,47,-542,-927,23.5,1458.4,14,1,0,4,2,5,0,0,0,0,15126,6.8,17574,211,52,542,927,21.1,1512.6
4509657547,1,17,6,1,12,11,12,0,0,0,0,19237,7.2,18874,209,72,981,369,20.9,1923.7,14,3,0,11,12,11,0,0,0,0,18256,7.0,18505,233,32,-981,-369,23.3,1825.6
4525301191,1,12,2,0,6,8,6,0,0,0,0,16047,6.8,18460,250,32,-518,-268,25.0,1604.7,16,3,1,8,6,3,2,1,1,0,16565,7.2,18728,211,47,518,268,21.1,1656.5
4508510246,0,14,2,1,7,7,4,0,0,0,0,16068,6.8,17309,193,42,-466,608,19.3,1606.8,20,2,0,7,7,9,0,0,0,0,16534,6.4,16701,224,29,466,-608,22.4,1653.4
4512128800,1,14,2,1,6,6,11,0,0,0,0,16700,7.0,17393,218,40,1806,4,21.8,1670.0,14,1,0,6,6,3,1,1,0,0,14894,6.6,17389,203,39,-1806,-4,20.3,1489.4
4420941972,1,25,3,1,6,5,7,1,0,1,1,17826,7.4,19427,225,67,1909,979,22.5,1782.6,16,3,0,5,6,3,0,0,0,0,15917,7.0,18448,220,48,-1909,-979,22.0,1591.7
4523734569,1,18,2,1,4,3,2,1,0,1,0,15668,7.0,18873,250,48,787,481,25.0,1566.8,18,2,0,3,4,1,1,1,0,0,14881,7.0,18392,221,60,-787,-481,22.1,1488.1
4494015371,0,11,1,0,3,5,4,1,1,0,0,13770,6.4,15846,192,33,-2374,-2316,19.2,1377.0,14,2,1,5,3,5,0,0,0,0,16144,7.0,18162,239,36,2374,2316,23.9,1614.4
4505276282,0,13,3,1,7,13,11,0,0,0,0,16571,6.4,15773,178,44,-1624,-3004,17.8,1657.1,21,2,0,13,7,15,0,0,0,0,18195,7.2,18777,207,32,1624,3004,20.7,1819.5
4525312579,0,80,5,0,6,7,3,0,0,0,0,15894,7.0,17808,212,52,-1019,-1564,21.2,1589.4,23,7,1,7,6,4,1,1,0,0,16913,7.2,19372,229,44,1019,1564,22.9,1691.3
4465268169,0,31,2,1,5,5,6,0,0,0,0,16256,7.2,17524,217,51,329,-994,21.7,1625.6,15,5,0,5,5,5,0,0,0,0,15927,7.2,18518,224,53,-329,994,22.4,1592.7
4474827626,1,16,3,0,3,10,4,1,1,0,0,14686,7.0,17582,206,60,-3593,-3240,20.6,1468.6,24,3,1,10,3,5,0,0,0,0,18279,7.6,20822,226,68,3593,3240,22.6,1827.9
4523321677,0,12,0,0,5,4,5,1,0,1,1,16888,7.2,18334,225,40,1063,-391,22.5,1688.8,14,1,1,4,5,2,1,1,0,0,15825,7.0,18725,231,55,-1063,391,23.1,1582.5
4472647396,1,44,7,0,3,4,1,1,1,0,0,15326,7.2,18992,226,59,-233,1969,22.6,1532.6,18,5,1,4,3,5,0,0,0,0,15559,6.6,17023,222,43,233,-1969,22.2,1555.9
4521172111,1,39,3,1,6,2,3,1,1,0,0,16569,7.2,19120,238,44,1398,1804,23.8,1656.9,17,18,0,2,6,3,0,0,0,0,15171,6.6,17316,233,60,-1398,-1804,23.3,1517.1
4492594471,0,33,4,1,5,7,6,1,1,0,0,15534,7.0,17293,207,44,-1109,-1493,20.7,1553.4,87,1,0,7,5,4,0,0,0,0,16643,7.2,18786,223,47,1109,1493,22.3,1664.3
4515616629,1,11,2,1,8,3,8,0,0,0,0,17628,7.2,18793,231,61,3539,2952,23.1,1762.8,123,2,0,3,8,4,0,0,0,0,14089,6.4,15841,195,46,-3539,-2952,19.5,1408.9
4495556599,1,38,4,0,7,3,6,0,0,0,0,16738,7.4,19318,219,61,1031,1909,21.9,1673.8,15,3,1,3,7,1,1,1,0,0,15707,7.0,17409,218,61,-1031,-1909,21.8,1570.7
4512957425,0,88,2,1,2,2,2,1,0,1,0,14505,7.0,18312,224,48,-838,-593,22.4,1450.5,15,6,0,2,2,1,1,1,0,0,15343,7.2,18905,253,67,838,593,25.3,1534.3
4517807085,1,17,1,1,6,3,7,1,0,1,1,17299,6.6,17431,223,36,1870,-729,22.3,1729.9,14,5,0,3,6,4,1,1,0,0,15429,7.0,18160,226,60,-1870,729,22.6,1542.9
4524160541,1,115,3,1,11,4,8,1,0,1,1,20176,7.6,19773,260,55,5830,1979,26.0,2017.6,25,1,0,4,11,0,0,0,0,0,14346,6.8,17794,194,52,-5830,-1979,19.4,1434.6
4437258310,1,17,5,1,5,3,8,0,0,0,0,15154,6.4,15685,206,28,1087,-1278,20.6,1515.4,21,5,0,3,5,1,0,0,0,0,14067,6.8,16963,192,43,-1087,1278,19.2,1406.7
4522214427,0,44,3,0,4,6,2,1,1,0,0,15044,7.0,17888,214,48,-2127,-997,21.4,1504.4,33,5,1,6,4,8,0,0,0,0,17171,7.2,18885,228,59,2127,997,22.8,1717.1
4523623443,0,13,6,0,6,13,6,0,0,0,0,16420,6.6,16281,223,40,-3593,-3086,22.3,1642.0,21,2,1,13,6,12,2,1,1,0,20013,7.4,19367,229,60,3593,3086,22.9,2001.3
4505535527,0,16,5,0,3,9,3,0,0,0,0,15365,6.8,17435,221,55,-2450,-1150,22.1,1536.5,18,3,1,9,3,12,0,0,0,0,17815,7.2,18585,233,40,2450,1150,23.3,1781.5
4442298197,0,18,2,1,9,6,13,1,1,0,0,17169,6.8,17934,216,33,-92,-1411,21.6,1716.9,14,0,0,6,9,6,1,0,1,0,17261,7.2,19345,221,63,92,1411,22.1,1726.1
4454438289,1,15,1,1,8,10,15,1,1,0,0,17231,7.0,17898,193,59,-1471,-1810,19.3,1723.1,16,5,0,10,8,11,0,0,0,0,18702,7.2,19708,213,52,1471,1810,21.3,1870.2
4527028383,0,92,3,1,3,6,0,1,1,0,0,14746,6.8,17610,206,56,-1108,-370,20.6,1474.6,16,1,0,6,3,6,0,0,0,0,15854,7.0,17980,210,52,1108,370,21.0,1585.4
4508952905,0,15,3,0,3,4,2,0,0,0,0,14961,7.0,18313,230,52,33,817,23.0,1496.1,24,5,1,4,3,3,1,1,0,0,14928,7.0,17496,191,55,-33,-817,19.1,1492.8
4525227627,1,22,4,0,4,5,2,1,1,0,0,16302,7.2,18728,256,56,315,667,25.6,1630.2,15,1,1,5,4,3,1,0,1,0,15987,6.8,18061,224,52,-315,-667,22.4,1598.7
4492253992,0,15,3,0,4,11,5,0,0,0,0,14606,6.4,16104,173,59,-4405,-3304,17.3,1460.6,57,3,1,11,4,16,1,1,0,0,19011,7.2,19408,193,63,4405,3304,19.3,1901.1
4514563057,0,15,2,0,7,9,6,0,0,0,0,16784,7.4,19211,196,64,-1270,1023,19.6,1678.4,15,3,1,9,7,10,0,0,0,0,18054,7.2,18188,210,47,1270,-1023,21.0,1805.4
4508876664,1,17,2,1,8,1,5,1,1,0,2,19820,7.2,19369,247,63,6883,5337,24.7,1982.0,13,1,0,1,8,1,1,0,1,0,12937,6.0,14032,179,37,-6883,-5337,17.9,1293.7
4497452633,1,17,4,0,9,5,7,0,0,0,0,17959,7.6,20494,239,56,1696,2266,23.9,1795.9,19,5,1,5,9,3,1,1,0,0,16263,6.8,18228,225,56,-1696,-2266,22.5,1626.3
4481963894,1,37,6,1,9,4,8,2,1,1,0,18591,7.4,20081,260,62,3105,2085,26.0,1859.1,37,2,0,4,9,5,0,0,0,0,15486,6.8,17996,208,70,-3105,-2085,20.8,1548.6
4520570200,0,16,2,0,2,4,0,0,0,0,0,14876,7.0,18374,218,68,-1187,-1561,21.8,1487.6,12,3,1,4,2,3,1,1,0,0,16063,7.4,19935,222,68,1187,1561,22.2,1606.3
4496344135,0,17,4,0,6,11,4,1,1,0,0,16036,6.6,16916,191,39,-2308,-1767,19.1,1603.6,19,6,1,11,6,14,0,0,0,0,18344,7.2,18683,206,28,2308,1767,20.6,1834.4
4518204390,0,14,3,1,11,12,9,0,0,0,0,17840,7.0,18114,175,51,-2425,-1827,17.5,1784.0,28,2,0,12,11,12,2,1,1,1,20265,7.4,19941,197,58,2425,1827,19.7,2026.5
4512177311,0,31,2,1,3,8,3,1,1,0,0,15315,6.8,17328,213,48,-2314,-2460,21.3,1531.5,14,6,0,8,3,11,0,0,0,0,17629,7.2,19788,237,61,2314,2460,23.7,1762.9
4450881054,1,16,4,1,8,3,9,1,1,0,0,17636,7.4,19295,249,51,2578,1160,24.9,1763.6,15,1,0,3,8,1,1,0,1,0,15058,7.0,18135,232,56,-2578,-1160,23.2,1505.8
4521242429,1,16,4,0,4,11,4,0,0,0,0,15120,6.4,16083,189,44,-3181,-2898,18.9,1512.0,56,3,1,11,4,14,0,0,0,0,18301,7.4,18981,214,48,3181,2898,21.4,1830.1
4507440061,0,41,4,1,9,6,10,1,1,0,0,17090,7.2,18470,216,44,989,755,21.6,1709.0,17,2,0,6,9,5,0,0,0,0,16101,6.8,17715,213,56,-989,-755,21.3,1610.1
4517740459,1,14,2,1,12,5,13,1,0,1,0,19266,7.4,19920,236,44,3362,2634,23.6,1926.6,17,3,0,5,12,6,0,0,0,0,15904,6.8,17286,204,44,-3362,-2634,20.4,1590.4
4523507584,1,15,0,1,8,12,5,1,1,0,0,16855,6.4,16841,216,44,-2672,-2811,21.6,1685.5,13,3,0,12,8,19,0,0,0,0,19527,7.4,19652,204,65,2672,2811,20.4,1952.7
4523865628,0,44,3,1,4,7,5,1,1,0,0,15920,6.6,17523,234,57,-1138,-1025,23.4,1592.0,37,19,0,7,4,8,0,0,0,0,17058,7.0,18548,237,41,1138,1025,23.7,1705.8
4500568578,0,15,4,0,1,4,2,1,1,0,0,13925,7.0,18363,216,60,-3617,-1967,21.6,1392.5,78,1,1,4,1,5,0,0,0,0,17542,7.4,20330,260,80,3617,1967,26.0,1754.2
4445477359,0,17,3,0,1,11,1,0,0,0,0,12789,6.4,15191,157,48,-6470,-5355,15.7,1278.9,15,2,1,11,1,13,1,1,0,0,19259,7.4,20546,256,63,6470,5355,25.6,1925.9
4522381918,1,110,4,1,7,5,8,0,0,0,0,17088,7.0,18086,204,53,180,893,20.4,1708.8,36,2,0,5,7,9,2,1,1,0,16908,6.8,17193,230,54,-180,-893,23.0,1690.8
4521679491,1,18,0,1,11,1,12,1,0,1,0,18137,7.0,18617,207,51,4177,2615,20.7,1813.7,35,2,0,1,11,0,0,0,0,0,13960,6.4,16002,205,54,-4177,-2615,20.5,1396.0
4496483924,1,15,1,1,10,6,10,1,1,0,0,18498,7.2,20017,238,56,1446,1597,23.8,1849.8,14,3,0,6,10,5,0,0,0,0,17052,7.0,18420,229,56,-1446,-1597,22.9,1705.2
4524773384,1,18,0,0,7,7,10,1,1,0,0,16585,6.8,16982,191,42,-536,-864,19.1,1658.5,17,1,1,7,7,9,0,0,0,0,17121,6.8,17846,234,52,536,864,23.4,1712.1
4497526633,0,16,0,0,3,4,2,0,0,0,0,14652,7.0,18395,235,42,-1075,11,23.5,1465.2,15,5,1,4,3,2,1,1,0,0,15727,7.2,18384,233,58,1075,-11,23.3,1572.7
4497823613,0,16,5,1,2,1,5,1,0,1,0,15063,6.6,17160,227,56,790,-1155,22.7,1506.3,19,2,0,1,2,0,1,1,0,0,14273,7.0,18315,217,68,-790,1155,21.7,1427.3
4522306510,1,40,0,0,5,4,7,1,1,0,0,15950,7.2,17916,220,56,-30,-200,22.0,1595.0,13,12,1,4,5,3,1,0,1,0,15980,7.0,18116,238,52,30,200,23.8,1598.0
4517900276,1,14,3,1,9,6,12,1,1,0,0,16574,6.6,17052,203,36,144,-227,20.3,1657.4,18,1,0,6,9,4,0,0,0,0,16430,6.8,17279,229,56,-144,227,22.9,1643.0
4509353286,1,17,2,0,9,3,8,1,1,0,0,17562,7.0,18512,224,50,1948,764,22.4,1756.2,15,0,1,3,9,6,0,0,0,0,15614,7.0,17748,202,62,-1948,-764,20.2,1561.4
4511176249,1,49,1,1,5,4,6,0,0,0,0,14991,6.8,17977,193,43,-274,-406,19.3,1499.1,17,3,0,4,5,3,1,1,0,0,15265,7.0,18383,217,56,274,406,21.7,1526.5
4519593233,1,145,3,1,8,6,10,1,0,1,0,17816,7.0,18186,226,47,1789,244,22.6,1781.6,17,3,0,6,8,11,1,1,0,0,16027,6.8,17942,210,60,-1789,-244,21.0,1602.7
4458628043,1,16,2,1,6,3,6,1,1,0,0,16847,7.4,19065,220,67,2341,2303,22.0,1684.7,14,4,0,3,6,3,0,0,0,0,14506,6.6,16762,214,38,-2341,-2303,21.4,1450.6
4518506408,0,14,3,1,8,5,4,1,0,1,1,17951,7.2,18661,244,50,2114,1904,24.4,1795.1,18,3,0,5,8,4,1,1,0,0,15837,6.4,16757,220,56,-2114,-1904,22.0,1583.7
4495498094,0,12,2,0,5,8,5,0,0,0,0,16317,7.0,17669,209,56,-1025,-1767,20.9,1631.7,14,2,1,8,5,4,0,0,0,0,17342,7.2,19436,245,56,1025,1767,24.5,1734.2
4443526032,0,35,4,0,4,7,6,0,0,0,0,15902,6.8,17995,241,48,-1190,-66,24.1,1590.2,27,6,1,7,4,14,1,1,0,0,17092,6.8,18061,241,57,1190,66,24.1,1709.2
4525369607,0,16,2,0,8,5,7,0,0,0,0,17337,7.0,18952,228,56,2429,2405,22.8,1733.7,44,3,1,5,8,5,1,1,0,0,14908,6.6,16547,198,46,-2429,-2405,19.8,1490.8
4473264225,0,18,1,1,6,15,9,0,0,0,0,16205,6.4,15951,171,44,-3719,-3695,17.1,1620.5,42,3,0,15,6,14,1,1,0,0,19924,7.4,19646,216,48,3719,3695,21.6,1992.4
4423246769,0,12,2,1,7,8,5,1,1,0,0,15810,6.6,16837,193,48,-1305,-2023,19.3,1581.0,12,0,0,8,7,5,0,0,0,1,17115,7.2,18860,189,62,1305,2023,18.9,1711.5
4524820601,1,11,1,1,9,11,11,0,0,0,0,17322,6.4,16229,182,52,-956,-1451,18.2,1732.2,14,1,0,11,9,12,1,1,0,0,18278,6.8,17680,207,49,956,1451,20.7,1827.8
4470842371,0,15,1,0,2,9,2,1,0,1,0,14475,6.6,16283,205,64,-4666,-3086,20.5,1447.5,14,4,1,9,2,9,1,1,0,1,19141,7.2,19369,224,58,4666,3086,22.4,1914.1
4487454478,1,15,1,1,10,4,11,0,0,0,0,18314,7.0,17903,219,31,3884,2224,21.9,1831.4,11,0,0,4,10,6,1,1,0,0,14430,6.6,15679,167,48,-3884,-2224,16.7,1443.0
4511868118,0,15,2,1,5,3,9,0,0,0,0,15692,6.4,16690,206,51,482,-2053,20.6,1569.2,39,4,0,3,5,2,1,0,1,0,15210,7.2,18743,235,54,-482,2053,23.5,1521.0
4506468475,1,17,4,1,7,8,8,1,1,0,0,16535,7.0,17930,230,28,-1123,-1665,23.0,1653.5,15,1,0,8,7,7,1,0,1,0,17658,7.0,19595,225,68,1123,1665,22.5,1765.8
4470529446,0,11,0,0,4,7,4,0,0,0,0,16182,7.0,18355,216,46,-925,-360,21.6,1618.2,15,0,1,7,4,7,2,1,1,0,17107,7.0,18715,212,67,925,360,21.2,1710.7
4495269641,0,16,1,0,5,8,4,1,0,1,0,15383,6.8,17243,227,28,-1524,-827,22.7,1538.3,11,3,1,8,5,11,0,0,0,0,16907,7.0,18070,186,39,1524,827,18.6,1690.7
4468603101,1,17,4,0,9,4,6,1,0,1,1,19663,7.2,19052,247,48,4043,1803,24.7,1966.3,15,0,1,4,9,5,0,0,0,0,15620,6.8,17249,214,51,-4043,-1803,21.4,1562.0
4516127508,1,39,3,0,6,2,6,2,1,1,0,15897,6.8,18168,188,68,1433,522,18.8,1589.7,18,2,1,2,6,1,0,0,0,0,14464,6.8,17646,215,51,-1433,-522,21.5,1446.4
4462104144,0,17,4,0,7,8,6,0,0,0,0,15330,6.2,15016,186,24,-1183,-1425,18.6,1533.0,19,3,1,8,7,10,1,1,0,0,16513,6.6,16441,199,37,1183,1425,19.9,1651.3
4487485538,0,18,1,0,3,9,1,1,0,1,0,14709,6.8,17193,207,56,-3224,-1270,20.7,1470.9,16,7,1,9,3,16,1,1,0,0,17933,7.2,18463,238,34,3224,1270,23.8,1793.3
4481332118,0,16,1,0,7,11,8,0,0,0,0,17151,6.8,17131,215,54,-2489,-2055,21.5,1715.1,14,1,1,11,7,18,1,1,0,0,19640,7.2,19186,205,65,2489,2055,20.5,1964.0
4507879201,1,18,4,0,9,11,11,1,1,0,0,17909,7.0,18562,214,43,-292,-506,21.4,1790.9,16,3,1,11,9,13,0,0,0,0,18201,7.2,19068,205,52,292,506,20.5,1820.1
4524576336,1,47,3,0,10,8,12,1,1,0,0,17342,7.0,17885,179,48,-447,-955,17.9,1734.2,13,0,1,8,10,5,0,0,0,0,17789,7.2,18840,206,44,447,955,20.6,1778.9
4518959670,0,15,0,0,9,5,15,1,1,0,0,16888,6.8,17236,200,48,993,783,20.0,1688.8,13,1,1,5,9,7,0,0,0,0,15895,6.4,16453,206,48,-993,-783,20.6,1589.5
4527098797,1,84,3,0,5,9,7,0,0,0,0,15791,7.0,17342,192,57,-1892,-580,19.2,1579.1,11,1,1,9,5,12,0,0,0,0,17683,7.2,17922,205,40,1892,580,20.5,1768.3
4475203157,0,15,6,1,6,2,11,0,0,0,0,17955,7.2,18774,270,43,3187,880,27.0,1795.5,17,1,0,2,6,1,1,1,0,0,14768,6.8,17894,230,64,-3187,-880,23.0,1476.8
4518772653,0,14,4,0,3,7,5,1,1,0,0,15070,6.8,18012,217,50,-2692,-1151,21.7,1507.0,15,3,1,7,3,14,0,0,0,0,17762,7.6,19163,225,52,2692,1151,22.5,1776.2
4476477033,1,13,2,1,7,3,1,2,1,1,1,18919,7.6,20248,252,73,3983,3375,25.2,1891.9,58,1,0,3,7,5,0,0,0,0,14936,6.8,16873,230,38,-3983,-3375,23.0,1493.6
4467974505,1,15,1,1,11,6,13,0,0,0,0,20245,7.6,21086,240,49,4151,3492,24.0,2024.5,34,1,0,6,11,9,0,0,0,0,16094,7.0,17594,171,55,-4151,-3492,17.1,1609.4
4510115879,0,18,2,0,4,12,6,0,0,0,0,15207,6.6,16955,213,44,-5324,-2914,21.3,1520.7,16,1,1,12,4,12,2,1,1,1,20531,7.2,19869,205,64,5324,2914,20.5,2053.1
4525240556,1,15,1,1,10,7,5,1,1,0,0,17214,7.2,18566,200,62,1690,1316,20.0,1721.4,38,2,0,7,10,9,0,0,0,0,15524,6.8,17250,162,42,-1690,-1316,16.2,1552.4
4490921913,1,15,4,0,7,2,7,1,1,0,0,18477,7.2,19323,275,45,4458,3839,27.5,1847.7,12,4,1,2,7,4,0,0,0,0,14019,6.2,15484,188,50,-4458,-3839,18.8,1401.9
4525175959,0,17,3,1,8,4,10,1,1,0,0,17161,7.2,18145,206,48,1577,-50,20.6,1716.1,17,3,0,4,8,2,0,0,0,0,15584,7.0,18195,214,48,-1577,50,21.4,1558.4
4513511494,1,9,2,0,8,5,5,1,0,1,0,17875,7.2,20182,206,80,2095,1664,20.6,1787.5,10,3,1,5,8,3,1,1,0,0,15780,7.0,18518,215,60,-2095,-1664,21.5,1578.0
4518841183,0,13,3,1,4,4,2,0,0,0,0,16003,6.8,17739,226,56,353,-160,22.6,1600.3,15,1,0,4,4,5,1,1,0,0,15650,6.8,17899,209,59,-353,160,20.9,1565.0
4520893771,1,15,16,1,3,2,4,2,1,1,0,15698,7.0,18088,253,56,-451,-1374,25.3,1569.8,43,5,0,2,3,1,0,0,0,0,16149,7.2,19462,255,75,451,1374,25.5,1614.9
4513209170,0,22,3,0,6,5,7,0,0,0,0,16818,7.4,18786,232,57,936,704,23.2,1681.8,17,2,1,5,6,2,2,1,1,0,15882,7.2,18082,221,54,-936,-704,22.1,1588.2
4520853492,0,19,2,0,11,7,14,1,0,1,0,18361,7.0,18709,234,43,1531,1680,23.4,1836.1,12,2,1,7,11,13,1,1,0,0,16830,6.8,17029,207,44,-1531,-1680,20.7,1683.0
4526454387,0,14,4,0,5,6,7,1,1,0,0,16227,7.2,19425,221,68,131,735,22.1,1622.7,17,3,1,6,5,8,0,0,0,0,16096,7.0,18690,206,44,-131,-735,20.6,1609.6
4419504973,0,19,4,1,6,9,7,0,0,0,0,16369,7.0,18174,236,51,-1673,-1221,23.6,1636.9,36,6,0,9,6,10,0,0,0,0,18042,7.4,19395,239,40,1673,1221,23.9,1804.2
4527623126,1,16,4,1,6,6,3,1,0,1,0,16904,7.2,18744,245,54,406,782,24.5,1690.4,18,3,0,6,6,9,1,1,0,0,16498,6.8,17962,210,58,-406,-782,21.0,1649.8
4480485955,0,14,2,0,3,5,4,1,0,1,0,14814,6.8,16691,216,39,-3082,-1694,21.6,1481.4,16,1,1,5,3,4,1,1,0,1,17896,6.8,18385,242,57,3082,1694,24.2,1789.6
4524528416,1,14,3,0,4,3,1,1,1,0,0,15195,7.0,18358,217,70,324,1794,21.7,1519.5,16,1,1,3,4,2,0,0,0,0,14871,6.4,16564,228,35,-324,-1794,22.8,1487.1
4513965875,0,16,11,0,3,13,6,0,0,0,0,14991,6.6,17279,207,53,-6050,-4081,20.7,1499.1,38,0,1,13,3,16,0,0,0,0,21041,7.6,21360,273,60,6050,4081,27.3,2104.1
4517907047,0,16,1,1,4,10,3,0,0,0,0,15419,6.4,17517,191,43,-2636,-839,19.1,1541.9,14,2,0,10,4,9,0,0,0,0,18055,6.8,18356,225,48,2636,839,22.5,1805.5
4522484818,0,16,2,1,8,8,8,0,0,0,0,17698,7.2,18605,218,56,-373,-1526,21.8,1769.8,14,2,0,8,8,5,1,1,0,0,18071,7.4,20131,233,76,373,1526,23.3,1807.1
4522819691,0,37,2,0,5,4,3,0,0,0,0,16021,7.2,19551,216,60,-470,1524,21.6,1602.1,16,1,1,4,5,4,0,0,0,0,16491,6.8,18027,237,50,470,-1524,23.7,1649.1
4493204321,0,15,2,0,2,8,1,0,0,0,0,14826,6.6,16327,222,37,-1635,-1544,22.2,1482.6,17,4,1,8,2,12,2,1,1,0,16461,6.8,17871,210,50,1635,1544,21.0,1646.1
4451399633,0,16,4,1,10,7,8,0,0,0,0,18410,7.2,19835,241,54,1720,1364,24.1,1841.0,19,3,0,7,10,6,0,0,0,0,16690,7.4,18471,212,46,-1720,-1364,21.2,1669.0
4524358757,1,83,3,0,9,8,12,1,1,0,0,17822,7.0,18329,209,44,-775,687,20.9,1782.2,15,2,1,8,9,8,0,0,0,1,18597,6.6,17642,219,44,775,-687,21.9,1859.7
4522794083,0,23,5,1,6,7,7,0,0,0,0,16182,6.8,17791,221,49,-95,-1113,22.1,1618.2,18,4,0,7,6,11,1,1,0,0,16277,7.0,18904,216,60,95,1113,21.6,1627.7
4484449974,1,16,2,1,5,0,4,1,0,1,0,16475,7.2,18879,231,55,2741,868,23.1,1647.5,12,2,0,0,5,0,1,1,0,0,13734,7.0,18011,233,60,-2741,-868,23.3,1373.4
4507609718,0,20,1,1,4,12,4,0,0,0,0,15263,6.6,15892,176,47,-2711,-282,17.6,1526.3,15,1,0,12,4,21,1,1,0,0,17974,6.6,16174,186,28,2711,282,18.6,1797.4
4520047610,1,16,2,0,6,6,7,0,0,0,0,16138,6.8,17204,211,31,-243,418,21.1,1613.8,11,3,1,6,6,13,1,0,1,0,16381,6.6,16786,188,52,243,-418,18.8,1638.1
4505097297,0,17,4,0,7,7,5,0,0,0,0,16374,6.6,17432,194,54,-255,1128,19.4,1637.4,23,1,1,7,7,7,1,1,0,0,16629,6.8,16304,194,50,255,-1128,19.4,1662.9
4471300165,1,17,4,0,7,5,7,1,1,0,0,17097,7.0,17368,199,62,1800,546,19.9,1709.7,17,3,1,5,7,9,0,0,0,0,15297,6.6,16822,182,41,-1800,-546,18.2,1529.7
4524641094,1,37,3,0,8,5,13,0,0,0,0,17129,6.8,17579,227,32,1192,449,22.7,1712.9,15,3,1,5,8,7,0,0,0,0,15937,6.8,17130,225,48,-1192,-449,22.5,1593.7
4497853195,1,17,5,1,9,3,11,0,0,0,0,19153,7.4,20631,262,51,4003,2755,26.2,1915.3,18,2,0,3,9,3,1,1,0,0,15150,7.2,17876,225,55,-4003,-2755,22.5,1515.0
4518065335,0,14,0,0,5,10,4,0,0,0,0,15660,7.0,18016,201,50,-2602,-550,20.1,1566.0,170,3,1,10,5,14,1,1,0,0,18262,7.2,18566,197,42,2602,550,19.7,1826.2
4456177266,0,13,1,1,6,8,5,0,0,0,0,16459,7.0,18612,201,58,-2021,-1891,20.1,1645.9,20,0,0,8,6,7,0,0,0,0,18480,7.4,20503,235,80,2021,1891,23.5,1848.0
4491873583,0,18,1,0,7,8,5,0,0,0,0,16456,6.8,16502,209,55,-706,-1460,20.9,1645.6,18,4,1,8,7,8,1,1,0,0,17162,6.8,17962,200,55,706,1460,20.0,1716.2
4522188300,0,18,4,0,5,4,7,1,0,1,0,15710,7.2,18847,239,43,-152,713,23.9,1571.0,17,3,1,4,5,5,1,1,0,0,15862,7.0,18134,218,74,152,-713,21.8,1586.2
4513135937,1,16,2,1,9,3,10,1,1,0,0,18266,7.2,19178,254,54,3360,1693,25.4,1826.6,16,2,0,3,9,2,0,0,0,0,14906,6.8,17485,235,48,-3360,-1693,23.5,1490.6
4525953760,0,30,5,0,5,11,2,1,0,1,0,16627,7.0,18559,229,64,-844,737,22.9,1662.7,61,6,1,11,5,14,0,0,0,0,17471,7.0,17822,206,40,844,-737,20.6,1747.1
4507604548,1,21,2,1,5,6,2,2,1,1,1,16874,6.8,17230,226,41,1319,556,22.6,1687.4,21,4,0,6,5,4,0,0,0,0,15555,6.8,16674,212,42,-1319,-556,21.2,1555.5
4511783197,0,31,5,0,5,4,5,0,0,0,0,15427,6.8,17722,215,50,-174,-503,21.5,1542.7,17,5,1,4,5,4,1,1,0,0,15601,7.0,18225,229,48,174,503,22.9,1560.1
4520868488,1,15,3,1,9,3,11,0,0,0,0,17592,7.0,18664,220,41,1411,766,22.0,1759.2,11,1,0,3,9,4,1,1,0,0,16181,7.0,17898,215,62,-1411,-766,21.5,1618.1
4447674252,0,11,2,0,2,9,2,0,0,0,0,13785,6.4,15847,195,44,-6199,-4997,19.5,1378.5,30,3,1,9,2,6,1,0,1,2,19984,7.6,20844,249,57,6199,4997,24.9,1998.4
4523758462,1,14,1,1,10,2,8,0,0,0,0,19733,7.6,20862,263,56,5228,3378,26.3,1973.3,13,2,0,2,10,2,1,1,0,0,14505,6.8,17484,210,64,-5228,-3378,21.0,1450.5
4445189250,0,19,2,1,2,5,1,1,1,0,0,14902,7.0,17656,242,44,-1186,-892,24.2,1490.2,14,4,0,5,2,6,0,0,0,0,16088,7.0,18548,215,47,1186,892,21.5,1608.8
4519784011,1,33,2,0,11,7,12,1,1,0,1,19241,7.0,18942,198,50,1350,577,19.8,1924.1,12,1,1,7,11,11,0,0,0,0,17891,7.0,18365,247,44,-1350,-577,24.7,1789.1
4527366202,1,39,1,0,1,10,1,1,0,1,0,14529,6.6,17127,218,56,-2930,-1894,21.8,1452.9,74,13,1,10,1,17,0,0,0,0,17459,7.2,19021,207,44,2930,1894,20.7,1745.9
4492577817,0,14,4,1,3,9,2,1,1,0,0,13769,6.2,15094,174,54,-4147,-3023,17.4,1376.9,16,4,0,9,3,7,0,0,0,0,17916,7.0,18117,217,48,4147,3023,21.7,1791.6
4524354626,0,22,1,1,9,3,16,1,0,1,0,18741,7.2,19102,243,44,3447,1976,24.3,1874.1,15,3,0,3,9,6,1,1,0,0,15294,6.8,17126,210,68,-3447,-1976,21.0,1529.4
4519645967,1,15,0,1,7,6,9,0,0,0,0,17537,7.0,18384,232,44,1752,830,23.2,1753.7,27,3,0,6,7,4,1,1,0,0,15785,6.8,17554,201,56,-1752,-830,20.1,1578.5
4509854436,0,12,3,0,11,14,8,0,0,0,0,18229,7.2,19238,198,48,-1502,-321,19.8,1822.9,12,0,1,14,11,14,1,1,0,0,19731,7.4,19559,186,43,1502,321,18.6,1973.1
4520667949,1,13,1,1,14,3,8,1,1,0,0,19085,7.2,19432,226,40,4784,3335,22.6,1908.5,14,1,0,3,14,2,0,0,0,0,14301,6.2,16097,178,47,-4784,-3335,17.8,1430.1
4511237975,1,18,1,0,3,7,3,0,0,0,0,15008,6.8,17439,214,56,-3688,-2808,21.4,1500.8,15,2,1,7,3,9,1,1,0,0,18696,7.4,20247,258,64,3688,2808,25.8,1869.6
4503193235,0,17,5,0,2,8,3,0,0,0,0,14176,6.8,17054,194,48,-3360,-1842,19.4,1417.6,19,3,1,8,2,7,1,1,0,0,17536,7.2,18896,228,56,3360,1842,22.8,1753.6
4516037651,0,47,1,0,7,5,5,0,0,0,0,16089,6.8,17265,198,45,-490,-217,19.8,1608.9,17,0,1,5,7,4,1,1,0,0,16579,6.8,17482,229,57,490,217,22.9,1657.9
4526727773,1,13,1,1,5,1,7,0,0,0,0,16786,7.4,19003,260,44,2264,1130,26.0,1678.6,14,3,0,1,5,1,2,1,1,0,14522,6.8,17873,247,61,-2264,-1130,24.7,1452.2
4521524486,1,16,3,1,5,5,7,0,0,0,0,16061,7.0,18238,210,60,530,1280,21.0,1606.1,14,2,0,5,5,5,0,0,0,0,15531,6.8,16958,204,44,-530,-1280,20.4,1553.1
4526026089,1,41,0,1,7,5,5,1,1,0,0,15954,7.0,17461,191,54,305,-374,19.1,1595.4,14,1,0,5,7,9,0,0,0,0,15649,6.8,17835,234,41,-305,374,23.4,1564.9
4461174959,0,40,2,1,5,8,6,1,1,0,0,15107,6.8,17606,187,44,-2607,-2365,18.7,1510.7,18,2,0,8,5,8,0,0,0,0,17714,7.4,19971,238,56,2607,2365,23.8,1771.4
4457404294,1,16,5,1,17,10,25,0,0,0,1,23335,7.6,20839,239,52,6790,5348,23.9,2333.5,14,0,0,10,17,11,0,0,0,0,16545,6.4,15491,129,26,-6790,-5348,12.9,1654.5
4500754839,1,14,4,0,4,10,4,1,1,0,0,15082,6.8,17691,211,49,-2924,-1587,21.1,1508.2,14,0,1,10,4,6,0,0,0,0,18006,7.4,19278,216,62,2924,1587,21.6,1800.6
4505993951,1,15,0,1,3,5,5,0,0,0,0,14896,6.8,17240,207,42,-2200,-1933,20.7,1489.6,53,2,0,5,3,6,2,1,1,0,17096,7.4,19173,235,63,2200,1933,23.5,1709.6
4460718392,0,14,0,0,0,12,0,0,0,0,0,12002,6.0,13961,151,44,-8461,-7340,15.1,1200.2,58,3,1,12,0,9,0,0,0,1,20463,7.8,21301,238,52,8461,7340,23.8,2046.3
4525953112,1,20,3,1,9,2,18,1,1,0,0,17936,7.0,18452,218,48,3350,1590,21.8,1793.6,16,2,0,2,9,2,0,0,0,0,14586,6.8,16862,213,58,-3350,-1590,21.3,1458.6
4467363451,1,17,8,1,10,5,13,0,0,0,0,17941,6.8,17529,206,52,1680,1254,20.6,1794.1,18,5,0,5,10,5,0,0,0,0,16261,6.4,16275,215,36,-1680,-1254,21.5,1626.1
4473969390,0,16,6,1,4,16,5,0,0,0,0,14813,6.0,14354,198,20,-5062,-5699,19.8,1481.3,21,7,0,16,4,22,2,1,1,0,19875,7.4,20053,250,45,5062,5699,25.0,1987.5
4498027358,0,14,4,0,5,7,4,0,0,0,0,14387,6.4,15777,158,48,-3214,-2195,15.8,1438.7,16,2,1,7,5,10,2,1,1,0,17601,7.0,17972,226,42,3214,2195,22.6,1760.1
4439137888,0,16,4,1,8,10,11,1,0,1,0,17064,6.6,16813,185,41,-574,-1413,18.5,1706.4,24,4,0,10,8,14,1,1,0,0,17638,6.8,18226,217,55,574,1413,21.7,1763.8
4493317372,1,12,1,1,5,4,5,1,1,0,0,15807,7.0,18131,219,59,70,409,21.9,1580.7,14,1,0,4,5,8,0,0,0,0,15737,7.0,17722,221,60,-70,-409,22.1,1573.7
4524333896,0,15,2,0,7,6,7,0,0,0,0,15778,6.2,15796,213,19,-1578,-2563,21.3,1577.8,13,1,1,6,7,3,2,1,1,1,17356,7.2,18359,201,56,1578,2563,20.1,1735.6
4452899588,1,13,3,1,9,2,8,1,1,0,0,17580,7.2,19527,210,46,3391,2897,21.0,1758.0,14,2,0,2,9,1,0,0,0,0,14189,6.6,16630,195,64,-3391,-2897,19.5,1418.9
4516181057,0,12,2,0,3,12,4,0,0,0,0,14015,6.4,15677,178,36,-4929,-3345,17.8,1401.5,15,3,1,12,3,16,1,1,0,0,18944,7.2,19022,228,48,4929,3345,22.8,1894.4
4513962663,0,20,2,1,8,7,5,1,0,1,0,16815,7.0,18326,207,41,10,223,20.7,1681.5,19,6,0,7,8,8,0,0,0,0,16805,6.8,18103,241,48,-10,-223,24.1,1680.5
4524652479,0,18,2,0,1,5,2,1,1,0,0,14445,6.8,17594,232,61,-925,41,23.2,1444.5,13,2,1,5,1,9,0,0,0,0,15370,7.0,17553,211,52,925,-41,21.1,1537.0
4504703082,0,11,4,1,6,10,6,0,0,0,0,15161,6.6,16711,187,36,-3312,-3119,18.7,1516.1,13,1,0,10,6,11,1,0,1,0,18473,7.4,19830,223,48,3312,3119,22.3,1847.3
4524501776,1,19,1,1,11,6,15,1,1,0,0,18230,6.8,17602,195,52,2114,75,19.5,1823.0,14,2,0,6,11,7,0,0,0,0,16116,6.8,17527,198,52,-2114,-75,19.8,1611.6
4526207203,1,24,4,1,8,5,6,0,0,0,0,17581,7.0,18639,243,45,1839,312,24.3,1758.1,122,1,0,5,8,2,1,1,0,0,15742,7.2,18327,221,45,-1839,-312,22.1,1574.2
4519154901,0,16,1,1,2,6,0,0,0,0,0,14072,6.6,16596,207,56,-2186,-1093,20.7,1407.2,37,1,0,6,2,7,1,1,0,0,16258,7.0,17689,210,54,2186,1093,21.0,1625.8
4522775881,1,14,2,1,7,4,8,1,1,0,0,17651,6.8,18454,229,60,3245,307,22.9,1765.1,16,2,0,4,7,3,0,0,0,0,14406,6.8,18147,179,52,-3245,-307,17.9,1440.6
4476006621,0,17,4,1,3,5,2,0,0,0,0,15562,7.2,18590,236,73,-764,803,23.6,1556.2,33,4,0,5,3,6,2,1,1,0,16326,6.8,17787,233,46,764,-803,23.3,1632.6
4479788915,1,16,2,1,8,4,8,2,1,1,1,19528,7.4,19755,257,56,3974,2785,25.7,1952.8,15,2,0,4,8,5,0,0,0,0,15554,6.8,16970,220,44,-3974,-2785,22.0,1555.4
4523319289,1,13,2,0,3,5,5,1,1,0,0,15597,7.2,18348,249,55,200,532,24.9,1559.7,10,1,1,5,3,2,0,0,0,0,15397,7.0,17816,203,60,-200,-532,20.3,1539.7
4519483858,0,18,4,1,5,12,1,0,0,0,0,15217,6.4,16160,193,39,-4199,-3576,19.3,1521.7,26,5,0,12,5,10,1,1,0,0,19416,7.2,19736,270,48,4199,3576,27.0,1941.6
4493188082,1,19,3,1,10,6,12,0,0,0,0,18384,7.2,18718,226,52,1717,1335,22.6,1838.4,17,2,0,6,10,10,0,0,0,0,16667,6.8,17383,229,43,-1717,-1335,22.9,1666.7
4522182843,1,14,2,0,8,11,9,0,0,0,0,17735,7.4,18655,203,56,-1421,-1547,20.3,1773.5,15,0,1,11,8,11,0,0,0,0,19156,7.4,20202,246,52,1421,1547,24.6,1915.6
4513953505,1,26,5,0,2,2,2,1,1,0,0,14541,6.8,18354,240,48,-1345,-621,24.0,1454.1,15,2,1,2,2,2,0,0,0,0,15886,7.2,18975,260,61,1345,621,26.0,1588.6
4513458480,1,14,3,1,10,2,14,1,1,0,0,18888,7.2,18447,242,43,4780,2748,24.2,1888.8,15,1,0,2,10,2,0,0,0,0,14108,6.4,15699,203,46,-4780,-2748,20.3,1410.8
4524674585,0,33,1,0,5,13,2,0,0,0,0,16145,7.0,17749,221,40,-2746,-1939,22.1,1614.5,13,1,1,13,5,14,1,1,0,0,18891,7.2,19688,229,58,2746,1939,22.9,1889.1
4524179867,0,11,5,0,6,12,8,0,0,0,0,15211,6.4,16421,187,47,-3746,-3014,18.7,1521.1,20,3,1,12,6,18,1,1,0,0,18957,7.2,19435,230,56,3746,3014,23.0,1895.7
4521806939,1,17,3,1,10,5,11,1,1,0,0,17556,6.8,17943,206,40,2153,799,20.6,1755.6,16,2,0,5,10,7,0,0,0,0,15403,6.8,17144,202,51,-2153,-799,20.2,1540.3
4519189625,1,16,0,1,6,1,7,0,0,0,0,16602,7.2,19275,246,54,2919,2298,24.6,1660.2,12,1,0,1,6,0,0,0,0,0,13683,6.6,16977,214,41,-2919,-2298,21.4,1368.3
4467537493,0,17,2,0,3,8,3,0,0,0,0,13817,6.4,14829,167,44,-3294,-2723,16.7,1381.7,13,3,1,8,3,5,1,1,0,0,17111,6.6,17552,206,48,3294,2723,20.6,1711.1
4523290421,0,17,3,1,7,10,7,0,0,0,0,16995,6.8,17908,217,44,-1666,-759,21.7,1699.5,17,5,0,10,7,15,1,1,0,0,18661,7.0,18667,243,60,1666,759,24.3,1866.1
4490435808,0,13,5,1,5,5,8,1,0,1,0,16009,6.8,18033,220,40,540,269,22.0,1600.9,15,2,0,5,5,8,1,1,0,0,15469,6.8,17764,185,54,-540,-269,18.5,1546.9
4455125565,0,15,4,0,3,11,2,0,0,0,0,14377,6.4,15120,158,44,-5141,-4745,15.8,1437.7,20,3,1,11,3,12,1,1,0,1,19518,7.4,19865,241,59,5141,4745,24.1,1951.8
4522867926,1,17,8,1,7,6,7,0,0,0,0,18248,7.2,19067,231,55,1989,1106,23.1,1824.8,37,2,0,6,7,3,1,1,0,0,16259,7.0,17961,215,55,-1989,-1106,21.5,1625.9
4514817366,1,66,6,1,9,3,17,1,1,0,0,16987,7.2,18514,189,40,2608,3387,18.9,1698.7,25,1,0,3,9,5,0,0,0,0,14379,6.4,15127,172,43,-2608,-3387,17.2,1437.9
4516668528,0,16,3,1,6,7,10,0,0,0,0,16245,6.8,16720,215,34,-713,-1111,21.5,1624.5,18,3,0,7,6,5,1,1,0,0,16958,6.8,17831,207,47,713,1111,20.7,1695.8
4467692885,0,17,1,0,5,7,4,0,0,0,0,15460,6.6,16868,184,56,-1946,-1148,18.4,1546.0,17,0,1,7,5,8,0,0,0,0,17406,7.0,18016,250,59,1946,1148,25.0,1740.6
4526435139,1,19,7,1,4,4,3,2,1,1,0,16127,6.8,18248,235,64,1071,644,23.5,1612.7,23,2,0,4,4,4,0,0,0,0,15056,6.6,17604,212,41,-1071,-644,21.2,1505.6
4526752854,0,15,5,0,9,4,7,0,0,0,0,16847,7.0,19212,211,45,1843,3584,21.1,1684.7,17,2,1,4,9,4,0,0,0,0,15004,6.2,15628,194,50,-1843,-3584,19.4,1500.4
4516124063,0,17,3,1,4,10,7,1,1,0,0,14719,6.6,16802,200,40,-2317,-1800,20.0,1471.9,16,2,0,10,4,10,1,0,1,0,17036,7.0,18602,194,45,2317,1800,19.4,1703.6
4472103382,0,14,3,1,8,3,8,1,1,0,0,16378,6.8,16837,178,44,393,-1055,17.8,1637.8,16,2,0,3,8,3,0,0,0,0,15985,6.8,17892,227,56,-393,1055,22.7,1598.5
4491026919,0,17,3,0,7,12,5,0,0,0,0,15674,6.4,15931,206,42,-3878,-3868,20.6,1567.4,37,3,1,12,7,15,1,1,0,0,19552,7.2,19799,207,55,3878,3868,20.7,1955.2
4527268691,0,17,2,1,13,8,12,0,0,0,0,18116,6.8,18447,187,40,838,914,18.7,1811.6,36,1,0,8,13,9,2,1,1,0,17278,7.2,17533,204,44,-838,-914,20.4,1727.8
4450495621,1,16,1,1,9,5,12,0,0,0,0,16759,7.0,17756,183,48,988,581,18.3,1675.9,13,5,0,5,9,9,2,1,1,0,15771,6.6,17175,198,59,-988,-581,19.8,1577.1
4526305174,0,17,4,1,7,4,11,0,0,0,0,17308,7.2,18538,213,44,1589,-197,21.3,1730.8,16,3,0,4,7,1,2,1,1,0,15719,7.0,18735,232,70,-1589,197,23.2,1571.9
4524120513,1,44,3,1,6,5,5,0,0,0,0,16246,7.2,18652,199,56,750,786,19.9,1624.6,14,1,0,5,6,6,0,0,0,0,15496,6.8,17866,199,50,-750,-786,19.9,1549.6
4524503051,0,15,4,0,4,4,5,0,0,0,0,15741,7.0,18215,224,63,-425,-284,22.4,1574.1,14,3,1,4,4,5,1,1,0,0,16166,7.0,18499,228,56,425,284,22.8,1616.6
4519887278,0,76,1,0,4,11,5,1,0,1,0,15373,6.6,16348,217,47,-4432,-3639,21.7,1537.3,14,2,1,11,4,16,1,1,0,0,19805,7.4,19987,226,80,4432,3639,22.6,1980.5
4523562611,1,20,0,0,0,5,0,0,0,0,0,14849,7.0,17923,249,68,-2145,-1335,24.9,1484.9,17,4,1,5,0,7,1,1,0,0,16994,7.4,19258,245,68,2145,1335,24.5,1699.4
4495222052,0,16,1,0,6,15,9,0,0,0,0,15435,6.6,15816,161,40,-5097,-3482,16.1,1543.5,17,3,1,15,6,16,1,1,0,0,20532,7.4,19298,226,44,5097,3482,22.6,2053.2
4465614811,1,17,2,1,6,3,5,1,1,0,0,16350,7.2,18813,233,44,1387,702,23.3,1635.0,14,1,0,3,6,3,0,0,0,0,14963,6.8,18111,217,56,-1387,-702,21.7,1496.3
4518540865,1,12,3,1,12,7,13,0,0,0,0,19049,7.6,20348,225,48,2900,2308,22.5,1904.9,14,1,0,7,12,5,1,1,0,0,16149,6.8,18040,172,52,-2900,-2308,17.2,1614.9
4448381986,0,18,3,0,7,7,10,0,0,0,0,16531,6.6,16364,202,44,-869,327,20.2,1653.1,29,2,1,7,7,9,1,1,0,1,17400,6.6,16037,219,48,869,-327,21.9,1740.0
4488597120,1,13,4,0,6,5,2,0,0,0,0,16589,7.0,18101,239,46,636,-419,23.9,1658.9,51,2,1,5,6,3,1,1,0,0,15953,7.2,18520,216,67,-636,419,21.6,1595.3
4492831778,1,12,3,0,8,10,8,0,0,0,0,15968,6.4,15868,145,42,-1912,-19,14.5,1596.8,15,3,1,10,8,13,1,1,0,0,17880,6.6,15887,191,33,1912,19,19.1,1788.0
4489906217,1,13,3,0,6,4,5,0,0,0,0,17047,7.2,19108,260,52,1604,1599,26.0,1704.7,14,0,1,4,6,5,1,1,0,0,15443,6.8,17509,209,44,-1604,-1599,20.9,1544.3
4522524149,0,39,1,0,4,12,5,0,0,0,0,14899,6.8,16761,190,36,-5515,-3391,19.0,1489.9,19,2,1,12,4,19,0,0,0,0,20414,7.4,20152,239,44,5515,3391,23.9,2041.4
4481631636,0,19,4,0,2,8,1,0,0,0,0,14208,7.0,17036,194,64,-4891,-2335,19.4,1420.8,20,1,1,8,2,8,1,0,1,1,19099,7.2,19371,266,40,4891,2335,26.6,1909.9
4523664992,0,42,5,1,10,5,11,0,0,0,0,19636,7.2,19567,247,55,4253,2731,24.7,1963.6,18,2,0,5,10,6,2,1,1,0,15383,6.6,16836,209,56,-4253,-2731,20.9,1538.3
4515511619,1,12,4,0,7,2,9,1,1,0,0,16664,7.2,18875,244,49,2543,965,24.4,1666.4,17,2,1,2,7,0,0,0,0,0,14121,7.0,17910,204,59,-2543,-965,20.4,1412.1
4514274061,0,16,1,0,5,5,7,0,0,0,0,14486,6.6,15962,170,29,-3299,-2719,17.0,1448.6,18,4,1,5,5,4,2,1,1,0,17785,7.0,18681,256,68,3299,2719,25.6,1778.5
4441457542,1,15,2,1,9,6,10,1,1,0,0,17592,7.4,19457,213,52,1572,2134,21.3,1759.2,16,4,0,6,9,9,1,0,1,0,16020,6.8,17323,211,42,-1572,-2134,21.1,1602.0
4505843833,1,15,5,1,11,9,8,0,0,0,0,17528,7.0,18271,191,48,171,618,19.1,1752.8,37,3,0,9,11,10,0,0,0,0,17357,6.6,17653,209,32,-171,-618,20.9,1735.7
4525161155,0,13,3,0,4,8,5,1,0,1,0,15577,6.6,16808,235,42,-2268,-1851,23.5,1557.7,21,3,1,8,4,7,1,1,0,0,17845,7.0,18659,239,63,2268,1851,23.9,1784.5
4524995677,0,16,4,1,6,8,2,1,1,0,0,15777,6.6,17401,224,53,-1370,-875,22.4,1577.7,20,2,0,8,6,9,0,0,0,0,17147,7.0,18276,210,36,1370,875,21.0,1714.7
4470330490,0,41,4,1,5,3,5,1,1,0,0,15704,7.2,18000,213,59,1208,1363,21.3,1570.4,19,4,0,3,5,3,0,0,0,0,14496,6.8,16637,209,52,-1208,-1363,20.9,1449.6
4517535335,1,27,9,0,6,5,6,1,1,0,0,16893,7.0,18950,238,64,568,1096,23.8,1689.3,43,8,1,5,6,6,0,0,0,0,16325,7.0,17854,231,48,-568,-1096,23.1,1632.5
4515507171,1,14,3,0,5,5,4,1,1,0,0,16313,7.0,18652,242,47,-152,-537,24.2,1631.3,18,4,1,5,5,5,0,0,0,0,16465,7.2,19189,213,64,152,537,21.3,1646.5
4517558941,0,16,2,0,2,10,1,0,0,0,0,13550,6.8,16368,194,44,-4982,-3368,19.4,1355.0,16,3,1,10,2,5,2,1,1,0,18532,7.4,19736,258,48,4982,3368,25.8,1853.2
4496431819,1,13,3,1,4,8,6,1,1,0,0,15077,7.0,17523,208,42,-2035,-1237,20.8,1507.7,15,2,0,8,4,7,0,0,0,0,17112,7.0,18760,231,54,2035,1237,23.1,1711.2
4513906148,1,20,3,1,10,2,12,1,1,0,0,19035,7.4,19265,239,60,5465,3492,23.9,1903.5,33,1,0,2,10,2,0,0,0,0,13570,6.4,15773,190,32,-5465,-3492,19.0,1357.0
4522626149,0,15,1,1,4,4,6,1,1,0,0,15544,6.6,17440,217,56,201,-979,21.7,1554.4,46,3,0,4,4,3,0,0,0,0,15343,7.0,18419,214,49,-201,979,21.4,1534.3
4438388290,0,17,2,0,6,7,4,1,0,1,0,16331,7.2,17920,231,49,-226,-221,23.1,1633.1,37,3,1,7,6,7,0,0,0,0,16557,7.0,18141,226,54,226,221,22.6,1655.7
4526466522,0,16,3,0,4,8,3,0,0,0,0,14756,6.8,17655,184,56,-4105,-2279,18.4,1475.6,16,2,1,8,4,8,1,1,0,0,18861,7.4,19934,229,63,4105,2279,22.9,1886.1
4525085237,1,12,1,1,2,5,1,1,1,0,0,14936,7.2,17688,231,53,-1543,-509,23.1,1493.6,14,2,0,5,2,8,0,0,0,0,16479,7.0,18197,250,40,1543,509,25.0,1647.9
4526376483,0,17,2,0,5,7,9,0,0,0,0,14690,6.4,15168,188,40,-5426,-3115,18.8,1469.0,14,0,1,7,5,9,1,1,0,2,20116,7.0,18283,245,43,5426,3115,24.5,2011.6
4486503067,1,17,2,1,6,5,9,0,0,0,0,17812,7.2,19411,263,69,2303,2950,26.3,1781.2,16,2,0,5,6,9,1,1,0,0,15509,6.6,16461,191,46,-2303,-2950,19.1,1550.9
4511665743,0,17,2,1,3,1,4,0,0,0,0,15615,6.8,18309,237,51,1471,187,23.7,1561.5,17,4,0,1,3,1,0,0,0,0,14144,6.8,18122,187,56,-1471,-187,18.7,1414.4
4500845226,1,18,4,1,5,1,5,2,1,1,0,16951,7.2,18681,270,43,1341,-85,27.0,1695.1,77,4,0,1,5,1,0,0,0,0,15610,7.2,18766,254,76,-1341,85,25.4,1561.0
4489642674,1,38,4,1,6,5,6,1,1,0,0,16098,6.8,18103,209,50,-282,-192,20.9,1609.8,16,4,0,5,6,5,1,0,1,0,16380,7.0,18295,224,62,282,192,22.4,1638.0
4518483468,0,14,6,1,7,3,11,0,0,0,0,17443,7.4,19184,238,45,2786,881,23.8,1744.3,15,4,0,3,7,2,0,0,0,0,14657,6.8,18303,212,57,-2786,-881,21.2,1465.7
4519643155,0,14,1,0,7,11,6,0,0,0,0,16548,6.8,17735,224,51,-2133,-256,22.4,1654.8,16,1,1,11,7,19,1,1,0,0,18681,7.0,17991,215,63,2133,256,21.5,1868.1
4520900550,1,43,1,0,8,4,3,0,0,0,0,17743,7.6,20843,247,56,2507,3436,24.7,1774.3,11,3,1,4,8,5,0,0,0,0,15236,6.8,17407,186,67,-2507,-3436,18.6,1523.6
4471166821,1,13,5,0,5,5,5,2,1,1,0,16122,7.2,19143,236,59,-221,1274,23.6,1612.2,15,2,1,5,5,7,0,0,0,0,16343,7.0,17869,225,41,221,-1274,22.5,1634.3
4525590476,1,19,6,1,8,6,10,2,1,1,0,17537,7.2,19766,236,60,2008,2714,23.6,1753.7,25,6,0,6,8,5,0,0,0,0,15529,6.8,17052,210,42,-2008,-2714,21.0,1552.9
4515649293,1,13,1,1,4,8,8,0,0,0,0,15352,6.4,15672,193,46,-1702,-1490,19.3,1535.2,15,1,0,8,4,13,1,1,0,0,17054,6.6,17162,191,44,1702,1490,19.1,1705.4
4502220585,1,19,4,1,15,4,23,1,1,0,1,22134,7.6,20809,234,59,8151,5114,23.4,2213.4,15,2,0,4,15,6,0,0,0,0,13983,6.2,15695,176,34,-8151,-5114,17.6,1398.3
4515686692,1,14,3,0,6,5,6,1,1,0,0,16454,6.8,17910,209,52,-247,-20,20.9,1645.4,36,1,1,5,6,6,0,0,0,0,16701,7.0,17930,227,48,247,20,22.7,1670.1
4522867814,1,20,12,1,4,5,5,0,0,0,0,15463,7.2,18378,215,60,25,327,21.5,1546.3,50,7,0,5,4,5,0,0,0,0,15438,7.0,18051,215,44,-25,-327,21.5,1543.8
4476445956,0,16,2,0,4,11,2,2,1,1,0,14657,6.8,16983,188,59,-3113,-1771,18.8,1465.7,20,1,1,11,4,20,0,0,0,0,17770,7.2,18754,201,45,3113,1771,20.1,1777.0
4506057736,0,16,2,0,1,5,2,1,0,1,0,13235,6.4,15728,187,40,-2466,-1449,18.7,1323.5,19,6,1,5,1,6,1,1,0,0,15701,6.6,17177,221,31,2466,1449,22.1,1570.1
4523056736,0,18,3,1,3,8,8,0,0,0,0,14451,6.8,16229,225,37,-3028,-3555,22.5,1445.1,33,5,0,8,3,8,1,0,1,0,17479,7.4,19784,223,60,3028,3555,22.3,1747.9
4516790351,0,39,1,0,3,12,3,0,0,0,0,14277,7.0,17550,201,53,-5802,-3559,20.1,1427.7,12,4,1,12,3,9,1,1,0,0,20079,7.6,21109,240,58,5802,3559,24.0,2007.9
4448485009,0,14,4,0,0,15,0,0,0,0,0,12971,6.4,14675,181,56,-6850,-6210,18.1,1297.1,18,3,1,15,0,16,1,1,0,0,19821,7.6,20885,236,40,6850,6210,23.6,1982.1
4497712537,1,17,4,1,6,6,11,1,1,0,0,17731,7.2,18498,257,59,1870,1167,25.7,1773.1,20,1,0,6,6,6,1,0,1,0,15861,6.8,17331,216,42,-1870,-1167,21.6,1586.1
4515248158,0,14,3,1,2,6,3,0,0,0,0,15584,6.8,17939,234,53,-1037,-1057,23.4,1558.4,15,4,0,6,2,13,0,0,0,0,16621,7.2,18996,222,56,1037,1057,22.2,1662.1
4477297316,1,16,2,1,4,3,3,1,0,1,2,17048,6.6,17678,206,48,2575,997,20.6,1704.8,14,3,0,3,4,4,1,1,0,0,14473,6.8,16681,214,43,-2575,-997,21.4,1447.3
4523054835,1,16,6,1,5,4,4,1,1,0,0,15481,6.8,17409,191,65,-253,111,19.1,1548.1,18,2,0,4,5,2,0,0,0,0,15734,6.6,17298,234,55,253,-111,23.4,1573.4
4445137863,0,18,2,0,3,7,3,0,0,0,0,14698,6.6,16625,224,53,-1723,-2525,22.4,1469.8,16,4,1,7,3,4,1,1,0,0,16421,7.0,19150,216,64,1723,2525,21.6,1642.1
4520934653,1,14,2,0,8,3,8,0,0,0,0,16847,7.2,18705,195,68,1255,2754,19.5,1684.7,13,0,1,3,8,2,0,0,0,0,15592,6.4,15951,247,33,-1255,-2754,24.7,1559.2
4497698751,0,39,4,0,3,8,3,0,0,0,0,14809,6.8,17625,232,44,-2595,-1917,23.2,1480.9,16,5,1,8,3,10,0,0,0,0,17404,7.2,19542,245,56,2595,1917,24.5,1740.4
4503018701,0,21,6,1,4,5,5,2,1,1,0,16427,7.0,18982,250,59,-342,-623,25.0,1642.7,19,4,0,5,4,5,0,0,0,0,16769,7.2,19605,247,63,342,623,24.7,1676.9
4525826341,1,11,1,0,4,9,3,1,1,0,0,15386,7.0,17872,209,40,-2820,-1143,20.9,1538.6,134,3,1,9,4,11,0,0,0,0,18206,7.4,19015,229,40,2820,1143,22.9,1820.6
4465670561,1,35,6,1,13,1,18,1,1,0,0,19641,7.4,19614,207,57,6310,5136,20.7,1964.1,14,1,0,1,13,3,0,0,0,0,13331,6.0,14478,199,40,-6310,-5136,19.9,1333.1
4527339142,0,48,1,1,5,4,5,1,1,0,0,15527,6.4,16705,185,44,625,-873,18.5,1552.7,15,1,0,4,5,2,0,0,0,0,14902,7.0,17578,226,44,-625,873,22.6,1490.2
4511365418,0,17,3,1,8,7,10,2,1,1,0,17429,7.0,17332,209,51,900,-802,20.9,1742.9,21,4,0,7,8,6,0,0,0,0,16529,7.0,18134,217,36,-900,802,21.7,1652.9
4518820210,0,12,1,0,2,6,2,0,0,0,0,14295,6.4,16196,211,40,-2514,-2762,21.1,1429.5,56,3,1,6,2,6,1,1,0,0,16809,7.2,18958,219,67,2514,2762,21.9,1680.9
4453399746,1,17,2,1,11,4,4,2,1,1,0,18271,7.2,20332,224,48,2875,3178,22.4,1827.1,12,2,0,4,11,4,0,0,0,0,15396,6.8,17154,213,56,-2875,-3178,21.3,1539.6
4455452551,1,24,5,0,8,10,5,0,0,0,0,17538,7.0,18073,224,41,238,840,22.4,1753.8,16,4,1,10,8,10,1,1,0,0,17300,6.8,17233,191,46,-238,-840,19.1,1730.0
4524902181,0,88,3,0,7,7,6,1,1,0,0,16476,6.6,17474,210,53,335,731,21.0,1647.6,22,2,1,7,7,4,0,0,0,0,16141,6.6,16743,206,40,-335,-731,20.6,1614.1
4473257949,1,18,2,1,5,3,7,2,1,1,0,15427,6.8,17667,217,47,134,-144,21.7,1542.7,19,4,0,3,5,2,0,0,0,0,15293,7.0,17811,235,51,-134,144,23.5,1529.3
4494756316,0,15,2,0,9,8,9,1,1,0,0,16884,6.4,17197,193,55,-968,-3,19.3,1688.4,17,3,1,8,9,6,1,0,1,0,17852,6.8,17200,210,45,968,3,21.0,1785.2
4437082520,0,16,4,1,10,6,11,1,1,0,0,17538,7.0,19111,219,48,34,145,21.9,1753.8,16,2,0,6,10,6,0,0,0,0,17504,7.2,18966,225,68,-34,-145,22.5,1750.4
4527270675,0,20,4,1,10,6,9,0,0,0,0,18344,7.2,18470,222,55,2326,987,22.2,1834.4,16,4,0,6,10,5,0,0,0,0,16018,7.0,17483,188,56,-2326,-987,18.8,1601.8
4479812747,0,16,5,0,5,8,7,0,0,0,0,16365,6.8,17954,225,51,-1754,-149,22.5,1636.5,16,4,1,8,5,13,1,1,0,0,18119,7.0,18103,243,48,1754,149,24.3,1811.9
4526523308,0,22,1,0,5,5,2,0,0,0,0,15752,7.0,18629,217,55,-717,8,21.7,1575.2,94,2,1,5,5,4,0,0,0,0,16469,7.2,18621,218,54,717,-8,21.8,1646.9
4446151894,1,12,4,0,2,8,1,1,1,0,0,14906,6.8,17928,229,55,-2361,-1663,22.9,1490.6,12,1,1,8,2,10,1,0,1,0,17267,7.0,19591,230,52,2361,1663,23.0,1726.7
4522528300,0,20,3,0,4,3,5,1,1,0,0,15562,7.2,18694,235,62,-526,496,23.5,1556.2,15,4,1,3,4,2,0,0,0,0,16088,7.0,18198,219,63,526,-496,21.9,1608.8
4526226027,0,55,7,0,3,4,7,1,0,1,0,14996,6.6,16984,221,47,-444,240,22.1,1499.6,20,5,1,4,3,8,1,1,0,0,15440,6.6,16744,197,42,444,-240,19.7,1544.0
4515582537,1,57,6,1,10,6,9,1,0,1,1,19276,7.2,19395,218,62,3942,2820,21.8,1927.6,19,2,0,6,10,6,0,0,0,0,15334,6.6,16575,189,29,-3942,-2820,18.9,1533.4
4514140656,1,21,1,1,12,6,15,1,1,0,0,18665,7.0,17762,213,37,2524,1040,21.3,1866.5,12,4,0,6,12,7,1,0,1,0,16141,6.6,16722,202,43,-2524,-1040,20.2,1614.1
4474588712,0,14,4,1,9,4,8,0,0,0,0,18471,7.4,19497,225,65,3252,2304,22.5,1847.1,15,3,0,4,9,3,1,1,0,0,15219,6.8,17193,201,62,-3252,-2304,20.1,1521.9
4521710145,0,14,1,0,3,6,4,0,0,0,0,15688,6.8,17439,239,52,-1434,-1422,23.9,1568.8,11,4,1,6,3,5,1,0,1,0,17122,7.0,18861,237,52,1434,1422,23.7,1712.2
4488944562,1,18,5,1,4,5,7,0,0,0,0,15340,6.6,16902,213,43,-885,-1554,21.3,1534.0,18,7,0,5,4,5,2,1,1,0,16225,7.2,18456,240,60,885,1554,24.0,1622.5
4479796051,1,18,4,0,7,4,11,0,0,0,0,17321,7.2,18397,233,41,2091,2518,23.3,1732.1,19,4,1,4,7,6,1,1,0,0,15230,6.6,15879,204,60,-2091,-2518,20.4,1523.0
4464257134,1,15,2,1,6,6,6,1,0,1,0,16866,6.8,17542,218,47,69,-552,21.8,1686.6,18,1,0,6,6,9,1,1,0,0,16797,6.8,18094,247,40,-69,552,24.7,1679.7
4417621987,1,17,6,1,8,8,12,0,0,0,0,17856,6.8,18232,221,50,226,-955,22.1,1785.6,11,2,0,8,8,8,1,1,0,0,17630,7.2,19187,221,50,-226,955,22.1,1763.0
4464924793,0,38,4,0,4,11,3,0,0,0,0,15939,6.8,17619,253,40,-1874,-1182,25.3,1593.9,77,6,1,11,4,7,1,0,1,0,17813,7.0,18801,221,36,1874,1182,22.1,1781.3
4524557404,0,16,2,0,4,9,4,0,0,0,0,15608,6.6,16536,197,50,-1690,-2943,19.7,1560.8,37,4,1,9,4,8,0,0,0,0,17298,7.2,19479,220,54,1690,2943,22.0,1729.8
4502124778,0,13,4,1,6,11,6,0,0,0,0,15240,7.0,17500,162,48,-3562,-2590,16.2,1524.0,16,0,0,11,6,8,1,1,0,0,18802,7.4,20090,221,48,3562,2590,22.1,1880.2
4480001106,1,34,3,1,10,6,9,0,0,0,0,17687,7.2,19488,197,67,1729,2306,19.7,1768.7,18,0,0,6,10,5,0,0,0,0,15958,6.8,17182,194,48,-1729,-2306,19.4,1595.8
4524963317,1,73,0,1,10,3,8,0,0,0,0,18130,7.0,18640,216,41,3905,1506,21.6,1813.0,23,1,0,3,10,3,1,1,0,0,14225,6.8,17134,173,56,-3905,-1506,17.3,1422.5
4482389592,1,16,3,0,7,5,9,1,1,0,0,16460,7.0,18782,222,52,192,616,22.2,1646.0,52,1,1,5,7,8,0,0,0,0,16268,7.2,18166,236,46,-192,-616,23.6,1626.8
4520562055,1,17,2,0,3,6,4,1,0,1,0,14920,6.8,17487,217,50,-1959,-630,21.7,1492.0,20,4,1,6,3,6,1,1,0,0,16879,7.0,18117,242,43,1959,630,24.2,1687.9
4526662466,0,12,3,1,7,5,8,1,0,1,0,17315,6.8,18122,229,50,1792,217,22.9,1731.5,40,2,0,5,7,8,1,1,0,0,15523,6.8,17905,226,47,-1792,-217,22.6,1552.3
4506848642,1,21,3,1,6,2,6,1,1,0,0,17303,7.0,18810,234,64,3643,3695,23.4,1730.3,16,0,0,2,6,3,0,0,0,0,13660,6.2,15115,179,52,-3643,-3695,17.9,1366.0
4518770887,0,18,3,0,2,5,5,0,0,0,0,14851,6.6,17101,245,41,-1068,-17,24.5,1485.1,14,1,1,5,2,7,2,1,1,0,15919,6.8,17118,212,46,1068,17,21.2,1591.9
4432016778,0,14,3,0,12,8,13,0,0,0,0,19306,7.4,19792,218,32,1087,340,21.8,1930.6,18,0,1,8,12,8,2,1,1,0,18219,7.4,19452,222,60,-1087,-340,22.2,1821.9
4526878026,0,19,3,1,5,8,2,0,0,0,0,15429,6.6,16825,227,48,-1480,-1366,22.7,1542.9,53,1,0,8,5,10,0,0,0,0,16909,6.8,18191,218,42,1480,1366,21.8,1690.9
4527479839,1,45,1,0,8,7,10,0,0,0,0,16347,6.8,16992,185,40,-559,-794,18.5,1634.7,15,4,1,7,8,4,1,0,1,0,16906,7.0,17786,215,49,559,794,21.5,1690.6
4524704735,1,20,3,0,4,2,4,0,0,0,0,16568,6.8,18658,242,56,1840,1870,24.2,1656.8,14,4,1,2,4,2,0,0,0,0,14728,6.6,16788,240,43,-1840,-1870,24.0,1472.8
4525358270,0,15,2,0,10,15,11,0,0,0,0,17318,7.0,17449,212,52,-3075,-2008,21.2,1731.8,12,4,1,15,10,16,2,1,1,0,20393,7.4,19457,214,52,3075,2008,21.4,2039.3
4481879494,1,15,0,0,3,4,3,1,1,0,1,17437,7.2,18302,255,59,3156,3919,25.5,1743.7,11,1,1,4,3,6,0,0,0,0,14281,6.0,14383,196,31,-3156,-3919,19.6,1428.1
4450553888,0,12,4,0,10,8,9,1,1,0,0,17344,7.0,18253,184,48,706,766,18.4,1734.4,21,2,1,8,10,7,1,0,1,0,16638,6.6,17487,206,40,-706,-766,20.6,1663.8
4447467809,0,16,3,0,8,6,15,1,0,1,0,15941,6.8,17256,162,51,-1870,-1732,16.2,1594.1,12,4,1,6,8,5,1,1,0,0,17811,7.4,18988,245,48,1870,1732,24.5,1781.1
4526188851,1,18,2,1,14,6,10,1,0,1,0,19203,7.4,20047,220,49,3548,3559,22.0,1920.3,16,1,0,6,14,7,1,1,0,0,15655,6.6,16488,204,30,-3548,-3559,20.4,1565.5
4479823004,1,18,1,0,13,9,18,1,1,0,0,19032,7.4,18951,232,44,527,721,23.2,1903.2,12,4,1,9,13,5,0,0,0,0,18505,7.0,18230,216,63,-527,-721,21.6,1850.5
4517647905,1,14,3,1,6,8,7,1,1,0,0,16058,7.0,17515,217,51,-677,-1382,21.7,1605.8,59,5,0,8,6,6,1,0,1,0,16735,7.2,18897,214,56,677,1382,21.4,1673.5
4509495092,0,17,1,0,1,5,0,1,1,0,0,14004,6.4,16302,217,39,-1113,-1381,21.7,1400.4,10,2,1,5,1,5,0,0,0,0,15117,7.0,17683,212,32,1113,1381,21.2,1511.7
4462682935,0,25,1,1,5,5,8,0,0,0,0,14966,6.4,16483,177,45,-1470,-1837,17.7,1496.6,17,5,0,5,5,10,1,1,0,0,16436,7.0,18320,220,59,1470,1837,22.0,1643.6
4471433408,0,16,4,1,10,6,11,1,1,0,0,18001,7.0,18571,216,50,1510,151,21.6,1800.1,14,2,0,6,10,6,0,0,0,0,16491,6.8,18420,231,45,-1510,-151,23.1,1649.1
4523860316,0,29,5,0,6,8,10,0,0,0,0,17394,7.0,18465,213,68,-14,-776,21.3,1739.4,42,3,1,8,6,8,2,1,1,0,17408,7.2,19241,215,63,14,776,21.5,1740.8
4457541720,1,12,2,1,3,3,2,2,1,1,0,15550,7.2,18425,249,56,-424,-1075,24.9,1555.0,15,4,0,3,3,5,0,0,0,0,15974,7.2,19500,245,68,424,1075,24.5,1597.4
4526981145,0,27,4,0,4,7,5,0,0,0,0,15398,6.8,17243,213,56,-1091,-617,21.3,1539.8,15,0,1,7,4,5,2,1,1,0,16489,6.8,17860,222,59,1091,617,22.2,1648.9
4475476612,1,159,4,0,8,7,5,0,0,0,0,17321,7.6,19677,238,48,703,477,23.8,1732.1,15,1,1,7,8,6,1,1,0,0,16618,7.2,19200,212,68,-703,-477,21.2,1661.8
4523482490,0,14,2,0,15,12,14,1,1,0,0,19632,7.6,20057,228,43,84,992,22.8,1963.2,15,6,1,12,15,9,0,0,0,0,19548,7.2,19065,237,40,-84,-992,23.7,1954.8
4517512393,1,14,4,1,9,8,5,1,1,0,0,15852,6.8,17330,194,35,-1918,-1739,19.4,1585.2,16,3,0,8,9,10,1,0,1,0,17770,7.2,19069,213,66,1918,1739,21.3,1777.0
4527045215,1,57,6,0,5,6,5,2,1,1,0,14875,6.8,17019,194,48,-1641,-602,19.4,1487.5,17,4,1,6,5,5,0,0,0,0,16516,6.8,17621,217,44,1641,602,21.7,1651.6
4520997585,0,46,4,1,7,4,11,1,1,0,0,16836,7.2,18457,205,48,1138,1758,20.5,1683.6,40,4,0,4,7,3,0,0,0,0,15698,6.6,16699,223,44,-1138,-1758,22.3,1569.8
4525208730,1,15,3,1,6,4,4,1,1,0,0,16645,7.2,19110,242,52,1151,470,24.2,1664.5,15,2,0,4,6,3,1,0,1,0,15494,7.0,18640,205,50,-1151,-470,20.5,1549.4
4518401885,0,13,3,1,2,7,1,1,1,0,0,13828,6.6,16629,204,38,-2622,-1136,20.4,1382.8,12,0,0,7,2,7,0,0,0,0,16450,6.8,17765,192,36,2622,1136,19.2,1645.0
4508197919,1,11,1,1,7,7,5,0,0,0,0,17024,7.2,19375,222,68,197,1883,22.2,1702.4,91,2,0,7,7,7,2,1,1,0,16827,7.0,17492,198,63,-197,-1883,19.8,1682.7
4518225344,1,14,6,1,5,5,6,1,1,0,0,16345,6.8,17499,246,45,134,-1022,24.6,1634.5,19,1,0,5,5,5,0,0,0,0,16211,7.2,18521,239,58,-134,1022,23.9,1621.1
4517945518,1,42,3,1,7,3,4,1,1,0,0,16305,7.0,18269,217,48,1947,1867,21.7,1630.5,13,14,0,3,7,2,0,0,0,0,14358,6.6,16402,180,56,-1947,-1867,18.0,1435.8
4524535912,1,14,0,1,9,8,9,0,0,0,0,16818,6.6,16998,208,44,-141,222,20.8,1681.8,14,0,0,8,9,11,1,1,0,0,16959,6.8,16776,164,48,141,-222,16.4,1695.9
4492936245,0,40,3,0,1,7,1,0,0,0,0,13325,6.6,16064,171,52,-3573,-2497,17.1,1332.5,18,3,1,7,1,12,2,1,1,0,16898,7.2,18561,230,51,3573,2497,23.0,1689.8
4504912203,0,39,7,1,3,4,3,0,0,0,0,14623,6.4,16060,200,36,-1585,-2306,20.0,1462.3,37,6,0,4,3,6,1,1,0,0,16208,6.8,18366,253,52,1585,2306,25.3,1620.8
4479366531,1,36,0,1,3,2,4,0,0,0,0,15751,7.0,18853,252,56,991,1570,25.2,1575.1,18,3,0,2,3,2,0,0,0,0,14760,6.8,17283,222,56,-991,-1570,22.2,1476.0
4522051549,0,16,3,1,8,11,8,0,0,0,0,17739,6.6,16482,215,55,377,-597,21.5,1773.9,22,4,0,11,8,12,2,1,1,0,17362,6.8,17079,197,44,-377,597,19.7,1736.2
4462251940,0,18,4,1,10,6,9,0,0,0,0,18725,7.4,19513,243,59,2376,1325,24.3,1872.5,16,3,0,6,10,5,0,0,0,0,16349,7.2,18188,215,52,-2376,-1325,21.5,1634.9
4515856568,0,12,5,1,5,9,3,1,1,0,0,15781,6.8,17614,203,60,-1980,-1595,20.3,1578.1,46,1,0,9,5,11,0,0,0,0,17761,7.2,19209,228,44,1980,1595,22.8,1776.1
4506208717,0,83,3,1,10,7,12,0,0,0,0,18592,7.2,19027,212,47,1577,678,21.2,1859.2,15,2,0,7,10,4,2,1,1,0,17015,7.0,18349,233,44,-1577,-678,23.3,1701.5
4518173580,1,51,11,1,9,1,9,0,0,0,0,18640,7.4,20923,249,63,4388,3527,24.9,1864.0,18,5,0,1,9,1,1,1,0,0,14252,6.8,17396,221,64,-4388,-3527,22.1,1425.2
4513367721,0,16,3,1,5,3,5,1,0,1,0,16128,7.0,17286,226,62,822,363,22.6,1612.8,17,4,0,3,5,5,0,0,0,0,15306,6.6,16923,229,44,-822,-363,22.9,1530.6
4521093374,0,43,1,1,6,8,10,0,0,0,0,15629,6.8,16806,176,52,-1537,-926,17.6,1562.9,15,4,0,8,6,9,0,0,0,0,17166,7.0,17732,186,36,1537,926,18.6,1716.6
4523669745,0,36,4,1,8,5,6,2,1,1,0,17622,7.2,19988,252,72,1530,2220,25.2,1762.2,51,6,0,5,8,9,0,0,0,0,16092,7.0,17768,239,41,-1530,-2220,23.9,1609.2
4517721680,1,16,3,0,2,7,4,1,1,0,0,14558,6.8,17024,206,63,-2564,-1959,20.6,1455.8,18,3,1,7,2,8,1,0,1,0,17122,7.2,18983,222,48,2564,1959,22.2,1712.2
4523841785,1,20,4,1,12,6,9,1,1,0,0,18259,7.2,19685,218,48,2254,1555,21.8,1825.9,17,4,0,6,12,3,0,0,0,0,16005,7.0,18130,215,42,-2254,-1555,21.5,1600.5
4495755195,1,11,0,0,11,8,11,1,0,1,0,18817,7.0,17845,192,54,311,559,19.2,1881.7,16,1,1,8,11,6,0,0,0,1,18506,6.8,17286,228,36,-311,-559,22.8,1850.6
4474905504,1,19,2,1,4,1,8,1,1,0,0,15787,7.2,19141,223,70,1259,2317,22.3,1578.7,18,2,0,1,4,0,0,0,0,0,14528,6.4,16824,236,47,-1259,-2317,23.6,1452.8
4524763167,1,19,2,0,17,10,21,0,0,0,1,22745,6.8,17394,205,23,4999,1094,20.5,2274.5,14,3,1,10,17,11,1,1,0,0,17746,6.4,16300,175,58,-4999,-1094,17.5,1774.6
4489783029,1,14,4,1,8,9,9,0,0,0,0,17273,7.0,18297,208,56,381,1571,20.8,1727.3,15,2,0,9,8,9,0,0,0,0,16892,6.8,16726,181,40,-381,-1571,18.1,1689.2
4524162182,1,15,5,1,6,2,8,1,1,0,0,18027,7.2,19090,252,53,3909,1938,25.2,1802.7,15,2,0,2,6,1,0,0,0,0,14118,6.6,17152,219,37,-3909,-1938,21.9,1411.8
4473666102,0,13,3,0,1,10,1,0,0,0,0,13785,6.8,16211,215,43,-4124,-3090,21.5,1378.5,16,3,1,10,1,13,1,1,0,0,17909,7.2,19301,260,54,4124,3090,26.0,1790.9
4524924257,0,14,3,0,4,9,1,1,0,1,0,14979,6.6,17213,210,52,-3414,-1141,21.0,1497.9,20,3,1,9,4,11,0,0,0,0,18393,7.2,18354,229,51,3414,1141,22.9,1839.3
4477243448,0,40,3,0,6,7,6,0,0,0,0,16302,6.8,17297,212,52,-211,-1305,21.2,1630.2,17,4,1,7,6,7,1,0,1,0,16513,7.2,18602,211,46,211,1305,21.1,1651.3
4514117878,1,22,8,1,7,2,9,1,1,0,0,18021,7.2,19353,246,50,4957,4440,24.6,1802.1,50,2,0,2,7,2,0,0,0,0,13064,6.4,14913,182,45,-4957,-4440,18.2,1306.4
4472568378,0,15,3,0,1,6,0,0,0,0,0,13921,6.6,16963,207,56,-2641,-2207,20.7,1392.1,16,3,1,6,1,5,1,0,1,0,16562,7.0,19170,242,44,2641,2207,24.2,1656.2
4513995465,0,15,3,0,2,9,0,1,1,0,0,14814,7.0,17587,222,64,-3402,-1459,22.2,1481.4,23,2,1,9,2,11,0,0,0,0,18216,7.4,19046,229,59,3402,1459,22.9,1821.6
4524183803,1,15,1,0,9,8,9,0,0,0,0,16872,7.0,17906,199,36,-1232,-272,19.9,1687.2,17,1,1,8,9,6,1,1,0,0,18104,7.0,18178,225,48,1232,272,22.5,1810.4
4508403894,1,23,3,1,4,7,5,0,0,0,0,16810,7.0,18437,224,76,-146,-399,22.4,1681.0,19,5,0,7,4,8,2,1,1,0,16956,7.0,18836,235,49,146,399,23.5,1695.6
4489796229,1,20,3,1,6,5,4,1,1,0,0,16130,6.8,17004,235,36,149,447,23.5,1613.0,15,7,0,5,6,3,0,0,0,0,15981,6.6,16557,241,40,-149,-447,24.1,1598.1
4513519782,1,17,1,0,7,8,5,0,0,0,0,16447,7.4,19247,215,52,-1422,345,21.5,1644.7,16,1,1,8,7,10,1,1,0,0,17869,7.2,18902,244,48,1422,-345,24.4,1786.9
4510751913,0,16,3,0,5,13,5,0,0,0,0,15069,6.2,14655,172,36,-4160,-6073,17.2,1506.9,48,4,1,13,5,10,1,1,0,0,19229,7.4,20728,231,69,4160,6073,23.1,1922.9
4480275637,1,17,4,1,4,4,4,0,0,0,0,15967,7.0,17892,225,62,-553,284,22.5,1596.7,18,1,0,4,4,4,2,1,1,1,16520,6.8,17608,217,44,553,-284,21.7,1652.0
4510971927,1,12,4,0,9,4,8,1,1,0,0,17524,7.0,18825,258,30,2764,2121,25.8,1752.4,16,1,1,4,9,3,0,0,0,0,14760,6.4,16704,208,34,-2764,-2121,20.8,1476.0
4521886990,1,20,3,1,7,2,13,1,1,0,0,17075,6.8,17444,202,56,1531,-222,20.2,1707.5,14,6,0,2,7,2,0,0,0,0,15544,6.8,17666,252,48,-1531,222,25.2,1554.4
4515338642,0,19,2,0,3,4,2,0,0,0,0,14564,6.6,17178,214,43,-1999,-647,21.4,1456.4,21,6,1,4,3,5,1,1,0,0,16563,7.0,17825,238,64,1999,647,23.8,1656.3
4467752796,1,16,2,1,13,5,10,1,0,1,0,18337,7.2,18978,194,43,3211,3640,19.4,1833.7,16,0,0,5,13,6,0,0,0,0,15126,6.4,15338,182,32,-3211,-3640,18.2,1512.6
4514156871,1,12,2,1,4,4,2,2,1,1,0,15534,7.0,18339,223,64,-483,-442,22.3,1553.4,14,2,0,4,4,5,0,0,0,0,16017,7.2,18781,266,52,483,442,26.6,1601.7
4513310043,1,18,7,1,7,8,3,0,0,0,0,16863,6.8,17725,206,42,783,-301,20.6,1686.3,18,5,0,8,7,7,1,1,0,0,16080,7.0,18026,186,44,-783,301,18.6,1608.0
4497724425,1,15,1,1,16,5,14,1,1,0,0,19098,7.0,18636,203,37,2447,247,20.3,1909.8,11,0,0,5,16,3,0,0,0,0,16651,7.0,18389,207,63,-2447,-247,20.7,1665.1
4522556160,0,23,3,0,4,6,5,0,0,0,0,16467,7.2,18715,261,56,-530,-123,26.1,1646.7,19,3,1,6,4,8,1,1,0,0,16997,7.0,18838,227,64,530,123,22.7,1699.7
4519196581,0,59,4,1,5,9,4,1,1,0,0,15534,6.6,16209,204,40,-2212,-1548,20.4,1553.4,17,4,0,9,5,8,0,0,0,0,17746,6.8,17757,215,60,2212,1548,21.5,1774.6
4478790073,1,11,7,0,8,3,10,1,1,0,0,17775,7.2,19408,256,49,2009,2090,25.6,1777.5,19,1,1,3,8,2,0,0,0,0,15766,6.6,17318,248,53,-2009,-2090,24.8,1576.6
4471380498,1,38,4,1,9,3,6,0,0,0,1,19574,7.6,20323,237,59,4279,3408,23.7,1957.4,20,5,0,3,9,6,0,0,0,0,15295,6.8,16915,234,58,-4279,-3408,23.4,1529.5
4482303478,0,14,2,0,2,12,1,0,0,0,0,14100,6.6,16725,204,48,-5508,-3521,20.4,1410.0,14,1,1,12,2,15,1,1,0,0,19608,7.6,20246,239,56,5508,3521,23.9,1960.8
4464829363,0,163,1,0,4,4,4,1,1,0,0,15639,7.0,18956,230,60,-1233,270,23.0,1563.9,17,5,1,4,4,5,0,0,0,0,16872,7.2,18686,243,56,1233,-270,24.3,1687.2
4477995331,0,66,2,1,8,8,13,0,0,0,0,17191,6.8,17401,188,56,654,478,18.8,1719.1,15,1,0,8,8,9,1,1,0,0,16537,6.6,16923,191,57,-654,-478,19.1,1653.7
4464898838,1,16,1,0,5,3,7,1,1,0,0,16860,7.0,18682,264,45,1245,686,26.4,1686.0,15,2,1,3,5,2,0,0,0,0,15615,7.0,17996,248,63,-1245,-686,24.8,1561.5
4440251539,1,15,4,1,10,7,6,1,1,0,0,17895,7.0,18393,208,45,2330,1713,20.8,1789.5,13,4,0,7,10,7,0,0,0,0,15565,6.6,16680,204,31,-2330,-1713,20.4,1556.5
4520969352,0,15,0,1,12,7,17,2,1,1,0,18292,7.0,18884,216,48,789,1319,21.6,1829.2,12,2,0,7,12,6,0,0,0,0,17503,6.8,17565,220,56,-789,-1319,22.0,1750.3
4478251083,0,17,2,0,11,11,8,1,1,0,0,17373,6.6,16452,178,41,-1768,-2230,17.8,1737.3,14,0,1,11,11,8,0,0,0,0,19141,7.2,18682,198,41,1768,2230,19.8,1914.1
4523932560,1,20,3,0,9,5,8,2,1,1,0,17615,7.2,19117,218,48,2643,3340,21.8,1761.5,15,3,1,5,9,6,0,0,0,0,14972,6.4,15777,194,41,-2643,-3340,19.4,1497.2
4520650445,0,15,6,0,7,5,12,1,0,1,0,16605,6.6,16894,220,39,2046,584,22.0,1660.5,20,5,1,5,7,9,1,1,0,0,14559,6.6,16310,175,44,-2046,-584,17.5,1455.9
4525128614,0,24,2,1,8,8,9,0,0,0,0,17238,6.8,17944,209,44,894,-3,20.9,1723.8,15,2,0,8,8,10,0,0,0,0,16344,7.0,17947,187,44,-894,3,18.7,1634.4
4527387593,0,12,3,1,3,5,3,0,0,0,0,15869,7.0,18217,261,48,-397,-163,26.1,1586.9,15,2,0,5,3,5,1,1,0,0,16266,7.0,18380,227,54,397,163,22.7,1626.6
4459583409,1,25,7,0,4,6,4,1,1,0,0,15883,6.8,17317,235,53,-426,-323,23.5,1588.3,17,4,1,6,4,6,0,0,0,0,16309,7.0,17640,238,42,426,323,23.8,1630.9
4523482714,0,31,0,0,5,12,2,0,0,0,0,14930,6.0,15593,169,56,-5298,-4670,16.9,1493.0,11,1,1,12,5,14,1,1,0,0,20228,7.4,20263,242,52,5298,4670,24.2,2022.8
4457658840,0,16,2,0,3,7,5,0,0,0,0,15442,6.6,17224,237,47,-2109,-1475,23.7,1544.2,20,4,1,7,3,10,1,1,0,0,17551,7.2,18699,233,50,2109,1475,23.3,1755.1
4477622010,0,15,3,0,2,12,3,1,1,0,0,13902,6.6,16677,173,60,-4535,-3079,17.3,1390.2,18,3,1,12,2,10,0,0,0,0,18437,7.2,19756,240,47,4535,3079,24.0,1843.7
4526071907,0,14,3,0,8,2,12,0,0,0,0,16861,7.0,18373,227,40,1297,564,22.7,1686.1,13,3,1,2,8,3,0,0,0,0,15564,7.0,17809,230,52,-1297,-564,23.0,1556.4
4486065632,1,40,1,0,6,6,6,0,0,0,0,15863,6.8,17012,221,29,46,881,22.1,1586.3,44,2,1,6,6,9,0,0,0,0,15817,6.4,16131,191,46,-46,-881,19.1,1581.7
4525242680,1,16,3,0,4,11,3,1,1,0,0,15786,6.6,17495,217,55,-4406,-2504,21.7,1578.6,20,5,1,11,4,15,0,0,0,1,20192,7.2,19999,233,68,4406,2504,23.3,2019.2
4520552197,0,20,4,1,12,7,11,1,1,0,0,18693,7.4,19277,206,50,1581,1899,20.6,1869.3,15,4,0,7,12,11,0,0,0,0,17112,6.6,17378,207,44,-1581,-1899,20.7,1711.2
4454069388,0,41,4,1,7,8,8,0,0,0,0,16604,6.6,17328,203,47,-416,-907,20.3,1660.4,17,6,0,8,7,11,1,1,0,0,17020,7.0,18235,201,55,416,907,20.1,1702.0
4522150515,1,24,2,1,5,3,7,0,0,0,0,16344,7.2,19039,238,52,1108,19,23.8,1634.4,38,2,0,3,5,1,2,1,1,0,15236,7.0,19020,244,54,-1108,-19,24.4,1523.6
4520393840,0,18,3,1,9,7,13,1,1,0,0,17682,6.6,17214,195,51,724,241,19.5,1768.2,40,3,0,7,9,9,0,0,0,0,16958,6.6,16973,229,48,-724,-241,22.9,1695.8
4484391297,1,13,2,0,4,4,0,1,0,1,1,17079,7.4,19361,250,66,1680,2384,25.0,1707.9,50,2,1,4,4,3,0,0,0,0,15399,6.6,16977,200,62,-1680,-2384,20.0,1539.9
4523850579,0,18,2,1,3,2,1,0,0,0,0,15097,7.2,18396,218,65,-429,55,21.8,1509.7,12,1,0,2,3,1,2,1,1,0,15526,7.2,18341,244,64,429,-55,24.4,1552.6
4468727943,0,12,0,1,3,7,4,1,1,0,0,14688,6.8,16866,199,52,-2193,-1574,19.9,1468.8,11,2,0,7,3,10,0,0,0,0,16881,7.0,18440,217,44,2193,1574,21.7,1688.1
4464656056,1,19,2,1,13,7,12,1,0,1,1,21783,7.6,20533,244,43,5638,3250,24.4,2178.3,38,2,0,7,13,7,0,0,0,0,16145,6.8,17283,167,47,-5638,-3250,16.7,1614.5
4494953738,1,19,8,0,2,4,2,0,0,0,0,14843,7.0,18146,236,43,-620,-147,23.6,1484.3,22,3,1,4,2,5,0,0,0,0,15463,7.0,18293,236,50,620,147,23.6,1546.3
4512135752,1,13,4,0,4,2,3,0,0,0,0,15750,7.0,18310,233,52,755,-289,23.3,1575.0,16,2,1,2,4,2,1,1,0,0,14995,7.0,18599,248,57,-755,289,24.8,1499.5
4517856513,0,21,5,0,4,10,7,0,0,0,0,15032,6.6,16564,203,44,-4481,-1530,20.3,1503.2,22,8,1,10,4,19,1,1,0,1,19513,7.0,18094,245,45,4481,1530,24.5,1951.3
4523343583,1,20,4,0,8,4,8,1,1,0,0,17463,7.0,18601,229,50,2337,2150,22.9,1746.3,20,3,1,4,8,3,0,0,0,0,15126,6.8,16451,204,39,-2337,-2150,20.4,1512.6
4410127520,1,17,15,0,9,3,9,0,0,0,0,18125,7.8,21102,236,48,2828,2738,23.6,1812.5,63,5,1,3,9,2,1,1,0,0,15297,7.2,18364,227,71,-2828,-2738,22.7,1529.7
4490516014,1,16,2,1,6,7,9,1,0,1,0,16512,7.4,18547,207,75,-1314,-1027,20.7,1651.2,39,2,0,7,6,10,1,1,0,0,17826,7.2,19574,246,67,1314,1027,24.6,1782.6
4516320607,0,12,1,0,7,5,6,1,1,0,0,15900,7.0,18137,206,48,-435,-960,20.6,1590.0,34,2,1,5,7,4,0,0,0,0,16335,7.0,19097,218,77,435,960,21.8,1633.5
4523348814,0,18,3,1,7,3,6,1,0,1,0,16300,7.0,18376,226,47,286,-12,22.6,1630.0,16,7,0,3,7,2,1,1,0,0,16014,6.8,18388,239,56,-286,12,23.9,1601.4
4520419730,1,18,2,1,5,6,5,2,1,1,0,16635,7.4,19221,235,76,152,-57,23.5,1663.5,37,3,0,6,5,10,0,0,0,0,16483,7.4,19278,233,40,-152,57,23.3,1648.3
4475950279,0,12,1,0,5,13,5,0,0,0,0,15881,6.6,16662,215,52,-3438,-2574,21.5,1588.1,19,3,1,13,5,9,1,1,0,0,19319,7.2,19236,222,52,3438,2574,22.2,1931.9
4477180489,0,14,5,0,3,14,7,0,0,0,0,14231,6.2,15543,208,44,-5316,-3648,20.8,1423.1,19,3,1,14,3,21,0,0,0,0,19547,7.4,19191,214,48,5316,3648,21.4,1954.7
4526206684,0,19,1,0,5,6,3,0,0,0,0,15580,6.6,17286,197,44,-502,-1113,19.7,1558.0,13,2,1,6,5,4,1,0,1,0,16082,7.2,18399,197,55,502,1113,19.7,1608.2
4503435524,0,35,3,0,2,5,1,0,0,0,0,14616,7.0,18564,242,48,-1441,55,24.2,1461.6,14,2,1,5,2,7,1,1,0,0,16057,6.8,18509,207,67,1441,-55,20.7,1605.7
4527522353,1,17,7,0,10,7,9,1,1,0,0,17712,7.0,19043,207,42,2370,3795,20.7,1771.2,18,3,1,7,10,6,0,0,0,0,15342,6.4,15248,186,38,-2370,-3795,18.6,1534.2
4473029808,1,47,4,0,12,2,18,0,0,0,0,19336,7.4,19593,221,59,4680,2780,22.1,1933.6,14,2,1,2,12,2,0,0,0,0,14656,6.8,16813,214,60,-4680,-2780,21.4,1465.6
4522251387,1,12,3,1,9,5,9,0,0,0,0,17309,7.0,18904,221,36,1425,728,22.1,1730.9,14,2,0,5,9,3,2,1,1,0,15884,6.8,18176,208,44,-1425,-728,20.8,1588.4
4435256740,0,14,5,1,7,4,5,1,1,0,0,17030,7.2,19832,250,49,1207,1638,25.0,1703.0,39,3,0,4,7,8,0,0,0,0,15823,7.0,18194,234,46,-1207,-1638,23.4,1582.3
4514234813,0,52,2,0,6,12,7,0,0,0,0,15456,6.6,16280,188,42,-4920,-3280,18.8,1545.6,15,1,1,12,6,11,1,0,1,1,20376,7.4,19560,240,62,4920,3280,24.0,2037.6
4488919662,1,15,3,1,4,6,4,1,1,0,0,15289,6.4,16346,193,52,-282,-740,19.3,1528.9,38,1,0,6,4,6,0,0,0,0,15571,6.8,17086,197,34,282,740,19.7,1557.1
4510548126,0,16,3,1,4,11,4,0,0,0,0,16314,6.8,16894,250,48,-2665,-900,25.0,1631.4,17,5,0,11,4,14,2,1,1,1,18979,7.0,17794,200,58,2665,900,20.0,1897.9
4527448169,0,15,4,1,3,8,5,0,0,0,0,15259,6.6,17346,206,64,-2738,-1759,20.6,1525.9,20,4,0,8,3,10,1,1,0,0,17997,7.2,19105,251,56,2738,1759,25.1,1799.7
4496800946,1,40,2,1,2,2,3,2,1,1,0,14653,7.0,17643,224,44,758,502,22.4,1465.3,17,4,0,2,2,0,0,0,0,0,13895,6.8,17141,221,50,-758,-502,22.1,1389.5
4525584970,0,16,1,1,7,5,10,1,0,1,0,16940,6.8,16731,232,40,1523,-576,23.2,1694.0,14,3,0,5,7,6,1,1,0,0,15417,6.8,17307,185,58,-1523,576,18.5,1541.7
4526171046,1,15,3,0,8,3,9,0,0,0,0,18334,7.0,19209,232,40,3770,1556,23.2,1833.4,37,1,1,3,8,2,1,1,0,0,14564,6.8,17653,195,59,-3770,-1556,19.5,1456.4
4523523505,1,12,2,1,7,1,12,1,1,0,0,17149,7.0,19250,216,53,3370,2895,21.6,1714.9,15,0,0,1,7,0,0,0,0,0,13779,6.4,16355,209,52,-3370,-2895,20.9,1377.9
4522273476,1,15,5,0,6,7,4,1,0,1,0,17248,7.0,19160,242,56,993,1759,24.2,1724.8,21,1,1,7,6,7,1,1,0,0,16255,6.8,17401,192,52,-993,-1759,19.2,1625.5
4523418547,0,12,1,0,3,8,2,0,0,0,0,14585,6.6,16310,225,38,-1321,-274,22.5,1458.5,11,0,1,8,3,4,2,1,1,0,15906,6.8,16584,185,64,1321,274,18.5,1590.6
4493059433,1,14,0,1,10,4,10,1,0,1,1,19107,7.4,20103,230,56,3799,2856,23.0,1910.7,11,2,0,4,10,3,0,0,0,0,15308,6.8,17247,210,56,-3799,-2856,21.0,1530.8
4484568700,1,19,4,1,3,2,2,0,0,0,0,15391,6.6,17387,232,41,1343,1089,23.2,1539.1,17,3,0,2,3,1,1,1,0,0,14048,6.4,16298,218,48,-1343,-1089,21.8,1404.8
4491586738,1,13,1,1,10,5,4,1,0,1,1,19634,7.2,19705,242,69,3966,2905,24.2,1963.4,12,0,0,5,10,8,1,1,0,0,15668,6.6,16800,203,48,-3966,-2905,20.3,1566.8
4524942450,0,14,2,1,9,7,8,1,0,1,1,18253,7.2,19481,203,45,1156,1711,20.3,1825.3,14,2,0,7,9,7,0,0,0,0,17097,7.0,17770,221,38,-1156,-1711,22.1,1709.7
4524850374,0,26,3,0,8,8,8,0,0,0,0,16357,6.6,16464,193,37,-232,97,19.3,1635.7,16,2,1,8,8,8,1,1,0,0,16589,6.6,16367,196,56,232,-97,19.6,1658.9
4504045676,1,16,8,0,6,3,4,1,0,1,0,16443,7.4,19348,261,51,1030,914,26.1,1644.3,42,5,1,3,6,5,1,1,0,0,15413,7.0,18434,235,47,-1030,-914,23.5,1541.3
4522209032,0,15,4,0,4,4,2,1,1,0,0,14697,7.0,17818,222,48,-1620,-1655,22.2,1469.7,16,1,1,4,4,4,0,0,0,0,16317,7.4,19473,255,72,1620,1655,25.5,1631.7
4470291861,1,16,2,0,12,7,19,1,1,0,1,20721,7.0,18605,247,49,4453,1296,24.7,2072.1,15,3,1,7,12,13,0,0,0,0,16268,7.0,17309,206,48,-4453,-1296,20.6,1626.8
4513159115,0,13,1,0,5,4,4,0,0,0,0,15977,7.0,18445,205,48,898,732,20.5,1597.7,18,2,1,4,5,2,0,0,0,0,15079,7.0,17713,215,44,-898,-732,21.5,1507.9
4495398614,1,15,0,1,9,12,11,0,0,0,0,17332,6.8,16861,170,47,-874,-1370,17.0,1733.2,16,2,0,12,9,11,0,0,0,0,18206,7.2,18231,218,48,874,1370,21.8,1820.6
4476872627,0,14,3,0,3,3,5,0,0,0,0,14259,6.4,15830,202,38,-1034,-846,20.2,1425.9,14,2,1,3,3,0,1,1,0,0,15293,6.6,16676,229,54,1034,846,22.9,1529.3
4518244695,0,31,2,0,2,3,4,0,0,0,0,15267,6.8,17987,226,80,-392,-995,22.6,1526.7,18,1,1,3,2,1,1,1,0,0,15659,7.4,18982,254,60,392,995,25.4,1565.9
4517750444,1,18,3,1,7,5,8,1,1,0,0,17561,6.6,17813,215,64,545,411,21.5,1756.1,16,1,0,5,7,1,1,0,1,1,17016,6.6,17402,218,44,-545,-411,21.8,1701.6
4455082508,1,17,2,0,9,4,9,1,0,1,0,18622,7.0,18509,230,44,2962,1156,23.0,1862.2,13,2,1,4,9,6,1,1,0,0,15660,6.8,17353,181,79,-2962,-1156,18.1,1566.0
4520567149,0,20,3,1,9,8,11,1,1,0,0,17429,6.8,17309,211,48,720,-183,21.1,1742.9,16,4,0,8,9,10,0,0,0,0,16709,6.8,17492,210,50,-720,183,21.0,1670.9
4496697436,0,12,4,0,5,10,6,0,0,0,0,15622,6.6,16556,200,43,-3909,-2136,20.0,1562.2,17,3,1,10,5,8,2,1,1,2,19531,7.2,18692,222,49,3909,2136,22.2,1953.1
4458793394,0,17,3,0,1,11,1,0,0,0,0,13265,6.4,15753,195,52,-6200,-3576,19.5,1326.5,18,3,1,11,1,8,1,1,0,1,19465,7.2,19329,248,44,6200,3576,24.8,1946.5
4500738441,0,23,2,1,5,9,4,0,0,0,0,15675,6.6,16844,229,39,-1614,-2256,22.9,1567.5,14,3,0,9,5,12,1,1,0,0,17289,7.2,19100,215,56,1614,2256,21.5,1728.9
4518416008,1,19,2,0,5,9,6,0,0,0,0,16032,6.8,17171,220,45,-2222,-1252,22.0,1603.2,15,1,1,9,5,10,1,1,0,0,18254,7.0,18423,225,40,2222,1252,22.5,1825.4
4513242798,0,16,3,1,7,4,4,0,0,0,0,16589,7.0,18105,231,49,-17,-355,23.1,1658.9,18,2,0,4,7,4,1,1,0,0,16606,7.2,18460,220,66,17,355,22.0,1660.6
4500814768,1,22,2,1,6,4,9,1,1,0,0,16231,6.8,17392,222,50,124,-2259,22.2,1623.1,13,3,0,4,6,2,0,0,0,0,16107,7.4,19651,239,68,-124,2259,23.9,1610.7
4507030336,0,20,2,1,6,9,7,0,0,0,0,17430,6.8,18068,212,63,-367,187,21.2,1743.0,15,3,0,9,6,9,0,0,0,0,17797,7.2,17881,205,60,367,-187,20.5,1779.7
4514830749,0,18,3,0,7,10,7,1,1,0,0,15842,6.6,17223,216,35,-3572,-1330,21.6,1584.2,21,5,1,10,7,10,0,0,0,1,19414,7.0,18553,225,36,3572,1330,22.5,1941.4
4517786912,0,14,3,1,5,7,6,2,1,1,0,15157,6.8,17194,218,38,-1301,-502,21.8,1515.7,14,2,0,7,5,8,0,0,0,0,16458,7.0,17696,209,52,1301,502,20.9,1645.8
4525344847,0,157,5,1,10,10,10,1,1,0,0,16722,6.8,17229,163,47,-790,-1172,16.3,1672.2,17,1,0,10,10,8,1,0,1,0,17512,7.0,18401,207,44,790,1172,20.7,1751.2
4474742854,0,15,4,1,6,7,2,0,0,0,0,15030,6.4,16763,204,36,-632,675,20.4,1503.0,17,4,0,7,6,8,1,1,0,0,15662,6.4,16088,192,45,632,-675,19.2,1566.2
4524830174,1,15,2,1,10,2,18,1,1,0,0,17559,7.0,17788,217,24,3158,1518,21.7,1755.9,13,1,0,2,10,3,0,0,0,0,14401,6.4,16270,184,47,-3158,-1518,18.4,1440.1
4522637303,1,21,5,1,12,4,16,1,1,0,0,19628,7.2,18889,229,38,4801,2127,22.9,1962.8,21,3,0,4,12,4,0,0,0,0,14827,6.8,16762,198,60,-4801,-2127,19.8,1482.7
4515934415,0,33,4,0,4,7,5,1,1,0,0,14205,6.4,15571,204,19,-4462,-3453,20.4,1420.5,18,1,1,7,4,7,0,0,0,0,18667,7.0,19024,269,57,4462,3453,26.9,1866.7
4492740165,1,19,2,0,8,7,8,0,0,0,0,17298,6.4,16912,233,43,326,1472,23.3,1729.8,13,5,1,7,8,11,1,1,0,0,16972,6.4,15440,210,32,-326,-1472,21.0,1697.2
4506553264,1,14,0,1,10,3,9,1,1,0,0,18096,7.2,19349,242,46,3738,4262,24.2,1809.6,11,4,0,3,10,4,0,0,0,0,14358,6.4,15087,198,47,-3738,-4262,19.8,1435.8
4523404428,1,18,2,0,8,2,8,1,1,0,0,17351,7.2,19306,235,55,3251,2936,23.5,1735.1,14,3,1,2,8,1,1,0,1,0,14100,6.6,16370,213,44,-3251,-2936,21.3,1410.0
4527888798,1,12,3,0,8,4,7,1,0,1,0,16882,7.2,18657,221,35,1632,1767,22.1,1688.2,12,2,1,4,8,4,0,0,0,0,15250,6.6,16890,179,44,-1632,-1767,17.9,1525.0
4518167002,1,16,3,1,6,3,4,1,1,0,0,16508,6.6,17714,243,45,2024,1979,24.3,1650.8,14,2,0,3,6,4,1,0,1,0,14484,6.4,15735,213,40,-2024,-1979,21.3,1448.4
4477407120,1,10,1,1,10,5,8,0,0,0,0,17465,6.8,17968,218,51,1428,463,21.8,1746.5,42,3,0,5,10,9,1,1,0,0,16037,6.8,17505,222,40,-1428,-463,22.2,1603.7
4521831054,0,44,4,1,9,6,8,1,0,1,0,17897,7.2,19344,217,53,1692,1998,21.7,1789.7,12,3,0,6,9,8,1,1,0,0,16205,7.0,17346,206,44,-1692,-1998,20.6,1620.5
4527210853,0,15,1,1,6,5,4,0,0,0,0,16663,7.0,18493,227,64,-29,-997,22.7,1666.3,11,2,0,5,6,4,1,1,0,0,16692,7.4,19490,225,76,29,997,22.5,1669.2
4495935822,1,20,4,0,7,5,8,0,0,0,0,16747,6.8,18344,198,40,1058,1735,19.8,1674.7,19,8,1,5,7,9,1,1,0,0,15689,6.6,16609,198,46,-1058,-1735,19.8,1568.9
4526037570,0,16,0,1,7,4,10,1,1,0,0,16339,7.0,17365,224,40,457,-959,22.4,1633.9,10,1,0,4,7,3,1,0,1,0,15882,7.0,18324,254,56,-457,959,25.4,1588.2
4477556217,0,18,0,0,2,9,3,0,0,0,0,14797,6.8,16690,213,52,-4265,-3190,21.3,1479.7,14,2,1,9,2,7,2,1,1,1,19062,7.2,19880,244,60,4265,3190,24.4,1906.2
4500758872,0,11,0,0,4,8,6,0,0,0,0,14327,6.6,16104,194,30,-3392,-2116,19.4,1432.7,15,2,1,8,4,7,1,1,0,0,17719,6.8,18220,223,41,3392,2116,22.3,1771.9
4518071306,1,18,3,1,15,8,12,1,1,0,0,20855,7.2,20164,196,46,4083,3740,19.6,2085.5,17,3,0,8,15,8,0,0,0,0,16772,6.6,16424,171,44,-4083,-3740,17.1,1677.2
4526479094,0,16,2,0,3,6,2,0,0,0,0,16178,7.0,19240,258,56,-183,257,25.8,1617.8,13,3,1,6,3,5,1,1,0,0,16361,7.2,18983,226,68,183,-257,22.6,1636.1
4494539160,0,16,3,0,8,11,6,1,0,1,0,17693,7.2,19111,202,52,-384,-345,20.2,1769.3,16,6,1,11,8,10,1,1,0,0,18077,7.2,19456,199,37,384,345,19.9,1807.7
4505058404,0,14,3,0,2,5,1,0,0,0,0,14815,7.0,17728,226,59,-2116,-2156,22.6,1481.5,16,5,1,5,2,6,1,0,1,0,16931,7.2,19884,237,80,2116,2156,23.7,1693.1
4452094519,1,43,4,1,4,3,2,1,0,1,1,16233,6.8,17972,210,52,1404,1286,21.0,1623.3,15,4,0,3,4,3,0,0,0,0,14829,6.8,16686,209,51,-1404,-1286,20.9,1482.9
4520001049,1,42,2,1,9,6,10,1,1,0,0,18395,7.4,19262,242,45,2862,1862,24.2,1839.5,17,3,0,6,9,4,0,0,0,0,15533,6.8,17400,200,40,-2862,-1862,20.0,1553.3
4505214335,0,12,3,1,4,7,4,0,0,0,0,15580,6.8,17701,205,52,-731,-118,20.5,1558.0,14,0,0,7,4,6,2,1,1,0,16311,6.8,17819,229,54,731,118,22.9,1631.1
4491049455,0,16,4,0,5,11,6,0,0,0,0,15424,6.6,16080,208,45,-3692,-3112,20.8,1542.4,14,4,1,11,5,16,2,1,1,0,19116,7.2,19192,195,55,3692,3112,19.5,1911.6
4522067733,0,17,0,0,1,7,0,0,0,0,0,14266,6.8,17850,222,56,-3389,-1855,22.2,1426.6,39,3,1,7,1,9,2,1,1,0,17655,7.4,19705,231,76,3389,1855,23.1,1765.5
4478166027,1,46,5,1,9,5,10,0,0,0,0,17413,7.0,17940,229,25,1221,-172,22.9,1741.3,15,0,0,5,9,7,0,0,0,0,16192,7.0,18112,213,67,-1221,172,21.3,1619.2
4526521494,0,18,3,1,5,4,9,0,0,0,0,15885,6.8,17840,233,35,-350,626,23.3,1588.5,15,5,0,4,5,5,0,0,0,0,16235,7.0,17214,221,56,350,-626,22.1,1623.5
4479756200,0,15,3,1,6,10,4,0,0,0,0,16123,6.6,16738,194,49,-2240,-1945,19.4,1612.3,17,2,0,10,6,13,0,0,0,0,18363,6.8,18683,223,52,2240,1945,22.3,1836.3
4438138890,1,18,0,0,6,8,6,0,0,0,0,16590,7.0,18284,213,49,544,75,21.3,1659.0,12,1,1,8,6,7,0,0,0,0,16046,7.0,18209,182,44,-544,-75,18.2,1604.6
4475253617,0,37,3,1,2,4,1,0,0,0,0,15101,7.0,18673,241,64,-1443,-269,24.1,1510.1,44,1,0,4,2,5,1,1,0,0,16544,7.0,18942,217,68,1443,269,21.7,1654.4
4485746291,1,19,4,0,11,1,13,1,0,1,1,20251,7.4,20985,263,61,6942,6381,26.3,2025.1,19,6,1,1,11,1,1,1,0,0,13309,6.2,14604,186,42,-6942,-6381,18.6,1330.9
4449478989,1,16,6,1,4,1,4,2,1,1,0,15492,7.0,18241,212,56,1412,737,21.2,1549.2,15,2,0,1,4,0,0,0,0,0,14080,6.8,17504,236,52,-1412,-737,23.6,1408.0
4515442306,1,19,5,0,2,6,2,0,0,0,0,14569,6.6,16380,234,52,-575,-1495,23.4,1456.9,43,6,1,6,2,3,1,1,0,0,15144,7.0,17875,200,52,575,1495,20.0,1514.4
4460445038,0,34,0,0,5,7,3,1,0,1,0,16616,7.0,18633,211,67,-47,318,21.1,1661.6,11,4,1,7,5,10,1,1,0,0,16663,7.0,18315,219,56,47,-318,21.9,1666.3
4447699269,0,37,5,0,10,6,18,0,0,0,0,17690,7.2,18278,192,45,1377,2429,19.2,1769.0,16,1,1,6,10,5,0,0,0,0,16313,6.6,15849,194,42,-1377,-2429,19.4,1631.3
4492581081,0,15,0,0,4,7,4,0,0,0,0,14686,6.4,15538,184,32,-3927,-3207,18.4,1468.6,14,2,1,7,4,4,1,0,1,1,18613,7.0,18745,262,46,3927,3207,26.2,1861.3
4513591449,0,19,2,0,4,5,2,0,0,0,0,15180,7.0,17773,210,52,-1705,-1839,21.0,1518.0,11,4,1,5,4,1,0,0,0,0,16885,7.2,19612,227,62,1705,1839,22.7,1688.5
4519445793,0,20,4,1,5,6,2,2,1,1,0,15304,6.6,17175,195,44,-1469,116,19.5,1530.4,17,3,0,6,5,8,0,0,0,0,16773,6.8,17059,238,46,1469,-116,23.8,1677.3
4459208674,1,19,3,0,3,4,1,1,1,0,0,15056,6.8,18397,225,51,-278,571,22.5,1505.6,15,2,1,4,3,7,0,0,0,0,15334,6.8,17826,208,59,278,-571,20.8,1533.4
4516180818,1,20,1,1,5,6,6,1,1,0,0,16035,6.8,16853,190,63,-608,-703,19.0,1603.5,47,6,0,6,5,8,0,0,0,0,16643,6.8,17556,210,48,608,703,21.0,1664.3
4477725637,0,15,6,0,6,7,12,0,0,0,0,15656,6.4,16252,195,44,-1275,-551,19.5,1565.6,21,3,1,7,6,8,1,1,0,0,16931,6.6,16803,202,44,1275,551,20.2,1693.1
4506832120,1,19,3,0,13,10,7,0,0,0,0,18388,7.0,18350,185,36,535,776,18.5,1838.8,18,3,1,10,13,10,0,0,0,0,17853,7.0,17574,198,56,-535,-776,19.8,1785.3
4523495162,0,12,2,0,9,11,6,0,0,0,0,17389,6.8,17933,226,36,-1428,-656,22.6,1738.9,15,1,1,11,9,12,1,1,0,0,18817,7.0,18589,237,43,1428,656,23.7,1881.7
4505847017,1,35,6,0,7,5,6,0,0,0,0,16555,7.2,18712,204,57,201,303,20.4,1655.5,45,7,1,5,7,6,1,1,0,0,16354,7.2,18409,210,64,-201,-303,21.0,1635.4
4518298214,0,16,2,1,12,13,14,0,0,0,0,18002,6.8,17743,178,43,-2340,-2351,17.8,1800.2,15,3,0,13,12,16,1,1,0,0,20342,7.6,20094,220,65,2340,2351,22.0,2034.2
4473903480,0,14,4,0,6,7,3,0,0,0,0,15827,6.6,17709,218,47,-1694,-603,21.8,1582.7,13,2,1,7,6,6,1,0,1,0,17521,7.0,18312,239,50,1694,603,23.9,1752.1
4523046488,0,14,4,0,7,3,10,1,1,0,0,16657,7.0,18425,231,43,1131,1518,23.1,1665.7,15,4,1,3,7,3,0,0,0,0,15526,6.6,16907,233,60,-1131,-1518,23.3,1552.6
4439587692,1,19,1,1,8,4,5,1,1,0,1,18355,7.0,18790,218,54,2756,1683,21.8,1835.5,13,5,0,4,8,5,0,0,0,0,15599,6.8,17107,200,57,-2756,-1683,20.0,1559.9
4525163715,0,36,6,0,2,12,2,0,0,0,0,13802,6.8,17008,202,52,-5571,-2139,20.2,1380.2,18,20,1,12,2,16,2,1,1,0,19373,7.2,19147,247,48,5571,2139,24.7,1937.3
4526844816,0,12,3,0,4,6,2,1,0,1,0,14372,6.8,16842,205,40,-1864,-2124,20.5,1437.2,19,4,1,6,4,3,0,0,0,0,16236,7.2,18966,216,54,1864,2124,21.6,1623.6
4515904262,1,17,1,0,8,7,7,0,0,0,0,17908,7.2,19202,229,54,653,430,22.9,1790.8,12,2,1,7,8,9,1,1,0,0,17255,7.2,18772,247,46,-653,-430,24.7,1725.5
4526009569,0,37,2,0,1,9,3,0,0,0,0,13719,6.4,16024,202,43,-4492,-4085,20.2,1371.9,16,3,1,9,1,8,0,0,0,0,18211,7.6,20109,219,75,4492,4085,21.9,1821.1
4494516149,0,37,3,0,4,7,4,1,0,1,0,16388,7.0,17168,220,50,-420,-1518,22.0,1638.8,14,4,1,7,4,10,0,0,0,0,16808,7.2,18686,239,37,420,1518,23.9,1680.8
4438038380,0,17,2,1,7,5,10,0,0,0,0,17098,7.2,18682,229,58,1733,862,22.9,1709.8,55,2,0,5,7,4,1,1,0,0,15365,6.8,17820,206,63,-1733,-862,20.6,1536.5
4476185279,0,43,3,0,9,12,8,0,0,0,0,17030,6.8,16983,176,41,-1567,1876,17.6,1703.0,15,0,1,12,9,15,0,0,0,0,18597,6.2,15107,171,36,1567,-1876,17.1,1859.7
4414955673,1,21,2,1,2,1,1,0,0,0,0,16528,7.4,20454,262,92,2617,3735,26.2,1652.8,12,3,0,1,2,1,1,1,0,0,13911,6.6,16719,231,48,-2617,-3735,23.1,1391.1
4525315485,0,15,0,0,6,8,6,0,0,0,0,16132,6.8,18331,199,57,-1850,-1016,19.9,1613.2,16,2,1,8,6,9,1,1,0,0,17982,7.4,19347,243,54,1850,1016,24.3,1798.2
4526636452,0,30,4,1,9,7,13,0,0,0,0,16374,6.6,15811,152,65,1057,-143,15.2,1637.4,16,3,0,7,9,6,1,1,0,0,15317,6.6,15954,196,44,-1057,143,19.6,1531.7
4527398202,0,64,4,0,7,9,13,1,1,0,0,17432,7.0,17080,200,52,-399,-1348,20.0,1743.2,29,4,1,9,7,11,0,0,0,0,17831,7.0,18428,203,48,399,1348,20.3,1783.1
4519787212,1,19,2,0,5,6,5,2,1,1,0,15594,7.0,18180,201,56,-1328,333,20.1,1559.4,23,4,1,6,5,7,0,0,0,0,16922,6.8,17847,227,60,1328,-333,22.7,1692.2
4523322393,1,16,2,0,4,4,3,0,0,0,0,15502,6.6,17035,221,53,631,1404,22.1,1550.2,21,2,1,4,4,5,1,1,0,0,14871,6.4,15631,207,48,-631,-1404,20.7,1487.1
4524113252,0,20,1,1,7,11,7,0,0,0,0,16171,6.4,16252,166,52,-2171,-2897,16.6,1617.1,21,5,0,11,7,13,1,1,0,0,18342,7.0,19149,220,43,2171,2897,22.0,1834.2
4512833184,0,47,1,0,3,3,4,1,1,0,0,16206,7.0,18093,260,54,-795,-1185,26.0,1620.6,35,24,1,3,3,4,1,0,1,0,17001,7.2,19278,242,80,795,1185,24.2,1700.1
4501838629,0,43,3,1,5,9,2,1,1,0,0,16099,7.0,18159,244,50,-1367,-1526,24.4,1609.9,19,14,0,9,5,9,1,0,1,0,17466,7.4,19685,197,64,1367,1526,19.7,1746.6
4525376845,0,31,2,0,4,1,5,2,1,1,0,15612,7.0,17678,234,61,1518,1208,23.4,1561.2,16,2,1,1,4,2,0,0,0,0,14094,6.8,16470,213,50,-1518,-1208,21.3,1409.4
4492300291,1,17,3,0,11,5,15,1,1,0,0,18204,7.0,18154,186,60,1790,350,18.6,1820.4,38,5,1,5,11,4,0,0,0,0,16414,7.0,17804,229,57,-1790,-350,22.9,1641.4
4526608631,1,20,3,1,2,1,3,1,1,0,0,15426,7.4,19072,230,79,711,1245,23.0,1542.6,15,3,0,1,2,1,0,0,0,0,14715,6.8,17827,255,54,-711,-1245,25.5,1471.5
4516510079,0,33,2,0,2,11,2,1,1,0,0,14099,6.6,16884,201,59,-3938,-2767,20.1,1409.9,18,1,1,11,2,8,0,0,0,0,18037,7.2,19651,218,53,3938,2767,21.8,1803.7
4511414132,0,13,3,1,5,5,7,0,0,0,0,15658,7.0,17569,224,45,-1047,-1618,22.4,1565.8,14,3,0,5,5,5,0,0,0,0,16705,7.2,19187,251,54,1047,1618,25.1,1670.5
4527275742,1,22,2,1,7,3,10,0,0,0,0,17755,7.2,19403,254,48,2864,3193,25.4,1775.5,14,3,0,3,7,3,0,0,0,0,14891,6.4,16210,221,41,-2864,-3193,22.1,1489.1
4515266360,1,36,2,0,2,8,2,0,0,0,0,14079,7.0,17003,207,43,-3388,-1882,20.7,1407.9,16,1,1,8,2,6,1,1,0,0,17467,7.2,18885,239,44,3388,1882,23.9,1746.7
4516562563,0,14,1,0,9,6,10,0,0,0,0,16760,6.8,16804,193,42,226,-957,19.3,1676.0,13,2,1,6,9,2,0,0,0,0,16534,6.8,17761,213,55,-226,957,21.3,1653.4
4522393633,0,18,8,0,4,5,5,1,1,0,0,15453,6.8,17463,191,55,-839,-623,19.1,1545.3,46,6,1,5,4,6,0,0,0,0,16292,6.8,18086,201,49,839,623,20.1,1629.2
4490720316,1,38,2,1,9,6,12,0,0,0,0,18869,7.0,18526,206,74,4242,2348,20.6,1886.9,15,1,0,6,9,6,0,0,0,0,14627,6.6,16178,164,51,-4242,-2348,16.4,1462.7
4523830454,0,14,1,1,5,5,8,0,0,0,0,15656,6.6,16766,230,40,-384,-2030,23.0,1565.6,13,1,0,5,5,2,1,1,0,0,16040,7.0,18796,233,56,384,2030,23.3,1604.0
4506917789,1,12,4,0,4,4,4,1,0,1,0,15607,7.0,18678,215,57,-315,718,21.5,1560.7,18,3,1,4,4,3,1,1,0,0,15922,6.8,17960,246,62,315,-718,24.6,1592.2
4450437970,1,35,0,1,6,4,4,2,1,1,0,15997,7.2,19158,195,60,499,2441,19.5,1599.7,21,1,0,4,6,4,0,0,0,0,15498,6.6,16717,210,41,-499,-2441,21.0,1549.8
4489343970,0,15,1,0,3,5,2,0,0,0,0,16102,7.2,19258,257,66,-281,110,25.7,1610.2,13,3,1,5,3,4,1,1,0,0,16383,7.0,19148,251,50,281,-110,25.1,1638.3
4523424930,1,15,6,1,4,4,7,0,0,0,0,16784,7.2,18335,267,47,992,-861,26.7,1678.4,14,2,0,4,4,5,1,1,0,0,15792,7.2,19196,224,80,-992,861,22.4,1579.2
4508930231,0,16,3,0,5,6,6,0,0,0,0,15268,6.6,17072,211,49,-2308,-1946,21.1,1526.8,12,2,1,6,5,8,1,1,0,0,17576,7.2,19018,263,56,2308,1946,26.3,1757.6
4450369263,1,18,2,1,2,4,2,1,1,0,0,14922,7.2,18119,227,65,-1316,-1111,22.7,1492.2,22,2,0,4,2,1,0,0,0,0,16238,6.8,19230,247,65,1316,1111,24.7,1623.8
4510908073,0,16,4,0,7,12,4,0,0,0,0,16115,7.0,17647,193,52,-3032,-1859,19.3,1611.5,14,4,1,12,7,7,0,0,0,0,19147,7.2,19506,243,47,3032,1859,24.3,1914.7
4524879680,0,14,1,1,4,6,5,0,0,0,0,14868,6.6,16330,182,48,-2281,-1594,18.2,1486.8,14,0,0,6,4,9,1,1,0,0,17149,6.8,17924,209,72,2281,1594,20.9,1714.9
4472605223,0,13,2,0,3,6,1,0,0,0,0,14980,6.8,17697,210,59,-2958,-1627,21.0,1498.0,43,4,1,6,3,4,1,1,0,0,17938,7.2,19324,268,65,2958,1627,26.8,1793.8
4472758849,0,37,0,0,3,6,1,0,0,0,0,15276,7.2,18400,214,59,-1729,-437,21.4,1527.6,14,3,1,6,3,8,1,1,0,0,17005,7.0,18837,250,52,1729,437,25.0,1700.5
4520842765,1,17,5,0,4,2,2,2,1,1,0,14729,6.8,18508,228,40,-17,588,22.8,1472.9,17,5,1,2,4,1,0,0,0,0,14746,6.8,17920,192,69,17,-588,19.2,1474.6
4464937851,0,17,1,0,7,7,7,1,1,0,0,16645,6.8,18070,231,44,-742,-750,23.1,1664.5,13,0,1,7,7,5,0,0,0,0,17387,7.0,18820,223,72,742,750,22.3,1738.7
4526731314,1,18,3,1,5,6,6,1,0,1,0,15743,6.6,16662,212,48,-720,-1533,21.2,1574.3,21,5,0,6,5,11,1,1,0,0,16463,7.0,18195,229,48,720,1533,22.9,1646.3
4481608154,1,19,6,1,7,5,5,0,0,0,0,18047,7.2,18160,239,59,2175,506,23.9,1804.7,20,6,0,5,7,4,1,1,0,0,15872,6.8,17654,229,60,-2175,-506,22.9,1587.2
4510666466,0,15,2,1,7,7,8,1,1,0,0,15970,6.8,17491,200,44,-336,-681,20.0,1597.0,17,4,0,7,7,4,0,0,0,0,16306,7.0,18172,220,40,336,681,22.0,1630.6
4514381198,1,183,2,0,8,11,8,0,0,0,0,16900,6.8,17296,168,52,-590,527,16.8,1690.0,10,0,1,11,8,10,0,0,0,0,17490,6.4,16769,186,48,590,-527,18.6,1749.0
4519840104,1,18,4,1,7,3,6,0,0,0,1,18100,7.0,18030,197,48,2690,236,19.7,1810.0,15,3,0,3,7,3,1,0,1,0,15410,6.8,17794,211,60,-2690,-236,21.1,1541.0
4511964473,0,16,3,1,5,7,7,1,1,0,0,15399,6.4,16243,196,48,-2164,-2554,19.6,1539.9,18,3,0,7,5,8,0,0,0,0,17563,7.0,18797,214,63,2164,2554,21.4,1756.3
4516392840,0,9,3,1,7,7,6,1,0,1,0,17634,7.2,18416,237,52,825,-1367,23.7,1763.4,14,0,0,7,7,4,1,1,0,0,16809,7.0,19783,215,59,-825,1367,21.5,1680.9
4512531903,1,17,2,1,6,2,4,0,0,0,0,16412,7.0,17900,235,47,1211,751,23.5,1641.2,14,6,0,2,6,2,1,1,0,0,15201,6.6,17149,249,52,-1211,-751,24.9,1520.1
4515508152,0,12,2,0,3,8,4,1,1,0,0,14580,6.6,16446,203,55,-4591,-1620,20.3,1458.0,14,1,1,8,3,6,0,0,0,1,19171,6.8,18066,241,45,4591,1620,24.1,1917.1
4522413426,1,15,0,1,4,2,5,0,0,0,0,16729,7.0,18725,227,48,1970,804,22.7,1672.9,16,1,0,2,4,2,0,0,0,0,14759,6.8,17921,228,73,-1970,-804,22.8,1475.9
4474642048,0,17,4,1,16,5,21,1,1,0,0,19234,7.0,18339,193,32,2899,1508,19.3,1923.4,16,4,0,5,16,7,0,0,0,0,16335,6.8,16831,211,61,-2899,-1508,21.1,1633.5
4525852452,0,15,1,0,1,3,1,1,1,0,0,13253,6.4,16475,190,51,-2310,-2290,19.0,1325.3,16,0,1,3,1,1,0,0,0,0,15563,7.4,18765,248,60,2310,2290,24.8,1556.3
4525865804,1,13,6,1,8,8,7,1,1,0,0,16613,6.8,17888,229,44,-271,99,22.9,1661.3,15,4,0,8,8,4,0,0,0,0,16884,6.8,17789,232,44,271,-99,23.2,1688.4
4513547440,0,14,4,1,4,10,2,0,0,0,0,15945,7.0,17784,229,56,-1757,-1856,22.9,1594.5,28,1,0,10,4,8,2,1,1,0,17702,7.2,19640,209,60,1757,1856,20.9,1770.2
4500155782,1,16,4,0,7,7,7,0,0,0,0,17250,7.2,18870,255,55,160,999,25.5,1725.0,15,2,1,7,7,5,0,0,0,0,17090,6.8,17871,231,52,-160,-999,23.1,1709.0
4471506446,1,22,2,1,18,4,14,2,1,1,0,21416,7.6,21031,235,57,7482,6466,23.5,2141.6,16,0,0,4,18,3,0,0,0,0,13934,6.0,14565,144,39,-7482,-6466,14.4,1393.4
4464955883,1,14,3,0,1,3,0,0,0,0,0,13918,7.0,17849,200,55,-1932,-41,20.0,1391.8,62,2,1,3,1,7,1,1,0,0,15850,6.8,17890,225,52,1932,41,22.5,1585.0
4473304091,0,37,4,0,3,4,3,0,0,0,0,14788,7.0,17425,227,46,-1605,-1335,22.7,1478.8,18,2,1,4,3,4,0,0,0,0,16393,7.2,18760,252,54,1605,1335,25.2,1639.3
4514643182,0,13,1,0,5,9,7,0,0,0,0,15449,6.6,16663,195,56,-2975,-2542,19.5,1544.9,17,3,1,9,5,15,1,1,0,0,18424,7.2,19205,258,48,2975,2542,25.8,1842.4
4525553823,1,14,0,0,10,4,13,1,1,0,0,19359,7.2,19182,243,53,4424,2663,24.3,1935.9,53,4,1,4,10,5,0,0,0,0,14935,6.8,16519,189,62,-4424,-2663,18.9,1493.5
4524784360,0,14,2,1,7,6,2,1,0,1,0,16756,7.0,18790,239,52,773,1285,23.9,1675.6,18,0,0,6,7,6,1,1,0,0,15983,6.8,17505,190,44,-773,-1285,19.0,1598.3
4451681116,0,12,2,1,2,6,1,0,0,0,0,14824,7.0,17975,214,59,-2465,-911,21.4,1482.4,14,2,0,6,2,6,1,0,1,0,17289,7.2,18886,243,60,2465,911,24.3,1728.9
4523538705,1,13,2,0,12,3,12,1,1,0,0,19226,7.4,20579,228,61,4389,5412,22.8,1922.6,17,2,1,3,12,5,0,0,0,0,14837,6.4,15167,217,35,-4389,-5412,21.7,1483.7
4515764294,0,16,1,0,4,12,4,0,0,0,0,16280,6.8,17372,223,54,-3279,-1466,22.3,1628.0,15,2,1,12,4,15,1,1,0,0,19559,7.2,18838,252,59,3279,1466,25.2,1955.9
4523611140,1,15,1,1,7,2,7,2,1,1,0,17325,7.6,20228,238,71,2905,2774,23.8,1732.5,15,0,0,2,7,3,0,0,0,0,14420,6.6,17454,222,52,-2905,-2774,22.2,1442.0
4482208801,0,18,0,0,3,5,6,0,0,0,1,16690,6.8,17992,248,48,-1060,-586,24.8,1669.0,43,1,1,5,3,7,2,1,1,1,17750,7.0,18578,214,75,1060,586,21.4,1775.0
4470320666,1,48,0,0,10,4,10,2,1,1,0,17973,7.2,20040,196,64,2507,3196,19.6,1797.3,17,1,1,4,10,5,0,0,0,0,15466,6.6,16844,209,48,-2507,-3196,20.9,1546.6
4516104541,0,43,4,1,7,7,9,1,0,1,0,16342,6.8,17877,211,40,-2579,-1094,21.1,1634.2,35,3,0,7,7,6,1,1,0,1,18921,7.2,18971,238,81,2579,1094,23.8,1892.1
4494122162,0,12,1,1,3,6,2,0,0,0,0,14607,6.8,17527,204,56,-2968,-2262,20.4,1460.7,40,2,0,6,3,8,2,1,1,0,17575,7.6,19789,243,56,2968,2262,24.3,1757.5
4522573873,0,20,8,1,4,6,8,0,0,0,0,17569,6.8,17848,265,40,1613,80,26.5,1756.9,16,4,0,6,4,4,2,1,1,0,15956,6.8,17768,214,60,-1613,-80,21.4,1595.6
4492536033,0,36,5,1,5,8,4,1,1,0,0,16396,7.2,18166,211,60,-1640,-907,21.1,1639.6,16,2,0,8,5,9,0,0,0,0,18036,7.2,19073,250,48,1640,907,25.0,1803.6
4525093722,1,17,2,1,15,7,19,1,1,0,0,20833,7.6,20278,231,36,4882,2906,23.1,2083.3,14,3,0,7,15,5,0,0,0,0,15951,6.8,17372,202,44,-4882,-2906,20.2,1595.1
4524568896,1,18,6,0,5,7,9,0,0,0,0,15851,7.0,19296,215,61,-1341,445,21.5,1585.1,19,6,1,7,5,6,1,1,0,0,17192,7.0,18851,237,38,1341,-445,23.7,1719.2
4521744333,0,16,2,1,2,4,3,1,0,1,0,15739,7.0,16738,223,46,657,-1141,22.3,1573.9,15,1,0,4,2,5,1,1,0,0,15082,6.8,17879,199,60,-657,1141,19.9,1508.2
4458668503,0,15,2,1,2,7,2,0,0,0,0,14270,6.4,15513,215,39,-3519,-4275,21.5,1427.0,14,3,0,7,2,8,1,1,0,0,17789,7.4,19788,241,56,3519,4275,24.1,1778.9
4522164250,0,15,6,0,2,7,2,0,0,0,0,14329,6.6,16330,211,47,-1966,-3591,21.1,1432.9,18,1,1,7,2,1,1,1,0,0,16295,7.2,19921,217,64,1966,3591,21.7,1629.5
4481881840,0,16,1,0,1,9,1,0,0,0,0,14109,6.4,16353,205,52,-3300,-3318,20.5,1410.9,12,0,1,9,1,7,0,0,0,0,17409,7.2,19671,231,39,3300,3318,23.1,1740.9
4522440155,0,15,3,0,1,2,1,1,1,0,0,15216,7.2,18663,251,56,99,-174,25.1,1521.6,12,2,1,2,1,5,0,0,0,0,15117,7.0,18837,217,60,-99,174,21.7,1511.7
4456330802,1,21,2,0,7,6,3,1,0,1,0,16653,7.4,19603,229,72,140,1737,22.9,1665.3,130,1,1,6,7,5,0,0,0,0,16513,7.0,17866,229,31,-140,-1737,22.9,1651.3
4514023677,0,15,3,1,3,6,3,0,0,0,0,15165,6.8,17462,218,62,-1995,-1194,21.8,1516.5,19,4,0,6,3,13,0,0,0,0,17160,7.2,18656,251,55,1995,1194,25.1,1716.0
4505063876,1,16,2,0,2,2,3,0,0,0,0,15830,7.2,19605,255,80,909,2001,25.5,1583.0,12,1,1,2,2,3,0,0,0,0,14921,7.0,17604,219,63,-909,-2001,21.9,1492.1
4518376722,1,13,1,1,8,3,9,2,1,1,0,18343,7.2,19519,235,59,3049,1511,23.5,1834.3,13,3,0,3,8,2,0,0,0,0,15294,7.0,18008,234,54,-3049,-1511,23.4,1529.4
4469812384,1,16,7,1,4,5,5,0,0,0,0,14707,6.6,16234,213,36,-2268,-2502,21.3,1470.7,22,4,0,5,4,5,1,1,0,0,16975,7.2,18736,254,62,2268,2502,25.4,1697.5
4462288936,0,105,0,0,3,8,2,0,0,0,0,14522,6.4,15305,211,39,-3596,-2738,21.1,1452.2,40,3,1,8,3,6,1,0,1,1,18118,7.0,18043,236,52,3596,2738,23.6,1811.8
4477165590,0,15,0,0,3,5,3,0,0,0,0,15767,7.2,18720,233,56,-943,140,23.3,1576.7,14,4,1,5,3,5,1,1,0,0,16710,7.2,18580,249,48,943,-140,24.9,1671.0
4483701739,0,20,2,0,3,10,3,1,1,0,0,14367,6.4,15957,192,53,-5085,-3236,19.2,1436.7,17,5,1,10,3,13,0,0,0,0,19452,7.4,19193,249,48,5085,3236,24.9,1945.2
4523422751,1,15,2,1,8,0,8,2,1,1,0,18519,7.2,20004,235,52,5222,3469,23.5,1851.9,10,0,0,0,8,0,0,0,0,0,13297,6.6,16535,187,68,-5222,-3469,18.7,1329.7
4522887845,1,18,1,1,6,5,5,1,1,0,0,16966,7.6,19311,231,58,138,1085,23.1,1696.6,12,1,0,5,6,6,1,0,1,0,16828,7.0,18226,214,58,-138,-1085,21.4,1682.8
4522207978,0,21,0,1,5,4,6,0,0,0,0,16158,7.4,19418,175,83,-811,1024,17.5,1615.8,15,4,0,4,5,2,2,1,1,1,16969,7.2,18394,232,48,811,-1024,23.2,1696.9
4505403710,0,15,3,1,7,2,13,1,1,0,0,16739,7.0,17995,229,56,1569,664,22.9,1673.9,16,0,0,2,7,2,0,0,0,0,15170,6.8,17331,250,48,-1569,-664,25.0,1517.0
4521327659,1,13,2,1,8,3,9,1,1,0,0,17428,7.2,19729,220,50,2087,2578,22.0,1742.8,17,4,0,3,8,2,0,0,0,0,15341,6.8,17151,229,65,-2087,-2578,22.9,1534.1
4461787791,1,89,3,1,7,5,7,1,1,0,0,17488,7.2,18635,220,51,1902,967,22.0,1748.8,54,6,0,5,7,6,0,0,0,0,15586,7.0,17668,193,60,-1902,-967,19.3,1558.6
4506149588,1,18,3,1,13,3,13,1,0,1,0,18928,7.4,19725,227,55,4184,3694,22.7,1892.8,40,3,0,3,13,2,0,0,0,0,14744,6.6,16031,180,57,-4184,-3694,18.0,1474.4
4497972211,1,16,4,0,4,3,5,0,0,0,0,15429,7.0,18085,238,41,39,-301,23.8,1542.9,15,3,1,3,4,2,1,1,0,0,15390,7.0,18386,238,60,-39,301,23.8,1539.0
4523536218,1,38,0,1,6,3,7,0,0,0,0,16887,7.4,19954,232,64,846,680,23.2,1688.7,14,21,0,3,6,1,1,1,0,0,16041,7.2,19274,242,64,-846,-680,24.2,1604.1
4524264529,1,12,4,0,5,8,5,1,1,0,0,16245,7.0,17547,206,52,-1051,753,20.6,1624.5,18,2,1,8,5,11,0,0,0,0,17296,6.8,16794,206,48,1051,-753,20.6,1729.6
4516175381,1,15,3,0,9,4,11,1,0,1,1,19684,7.4,20073,217,60,3920,3302,21.7,1968.4,19,1,1,4,9,3,1,1,0,0,15764,6.6,16771,219,48,-3920,-3302,21.9,1576.4
4525860458,1,44,3,1,6,2,7,0,0,0,0,17311,7.0,18763,257,52,2781,1229,25.7,1731.1,13,15,0,2,6,2,0,0,0,0,14530,6.8,17534,216,60,-2781,-1229,21.6,1453.0
4499995940,1,16,3,0,5,6,3,0,0,0,0,16177,7.0,18401,216,60,-126,463,21.6,1617.7,17,3,1,6,5,6,2,1,1,0,16303,6.6,17938,215,58,126,-463,21.5,1630.3
4465399083,0,15,2,0,1,7,1,0,0,0,0,13745,6.6,16710,198,55,-3426,-997,19.8,1374.5,72,4,1,7,1,9,1,1,0,0,17171,7.0,17707,212,60,3426,997,21.2,1717.1
4513554113,0,16,2,0,0,7,0,0,0,0,0,12774,6.6,15643,199,44,-4538,-2876,19.9,1277.4,23,3,1,7,0,13,1,1,0,0,17312,6.8,18519,250,57,4538,2876,25.0,1731.2
4526824134,1,13,1,0,5,8,2,1,1,0,0,15424,6.6,16777,218,48,-1668,-866,21.8,1542.4,14,2,1,8,5,10,0,0,0,0,17092,7.2,17643,191,52,1668,866,19.1,1709.2
4527526766,0,18,3,1,7,8,6,0,0,0,0,16132,7.0,17360,207,48,-1211,-2257,20.7,1613.2,35,2,0,8,7,9,1,0,1,0,17343,7.2,19617,244,52,1211,2257,24.4,1734.3
4423083360,0,14,2,0,3,5,2,0,0,0,0,15148,7.0,18263,213,50,-1416,63,21.3,1514.8,15,2,1,5,3,8,1,1,0,0,16564,7.0,18200,230,67,1416,-63,23.0,1656.4
4492296802,0,11,6,0,5,2,8,1,1,0,0,16496,6.8,18200,251,64,1506,-169,25.1,1649.6,46,2,1,2,5,1,1,0,1,0,14990,7.0,18369,224,68,-1506,169,22.4,1499.0
4485497527,1,17,6,0,4,5,4,1,0,1,0,16178,7.6,19249,223,80,297,1259,22.3,1617.8,19,4,1,5,4,5,0,0,0,0,15881,7.0,17990,225,48,-297,-1259,22.5,1588.1
4519347640,0,17,1,1,6,9,2,0,0,0,0,15498,6.6,16711,201,47,-1384,-853,20.1,1549.8,16,2,0,9,6,9,1,1,0,0,16882,6.6,17564,190,64,1384,853,19.0,1688.2
4462059327,0,13,2,0,5,6,5,0,0,0,0,16084,6.8,17317,219,46,-859,-2114,21.9,1608.4,17,1,1,6,5,5,1,1,0,0,16943,7.4,19431,244,60,859,2114,24.4,1694.3
4497766397,0,17,3,1,6,7,2,0,0,0,0,15894,6.6,16813,205,48,-399,-868,20.5,1589.4,19,4,0,7,6,4,1,1,0,0,16293,7.0,17681,213,44,399,868,21.3,1629.3
4520799131,0,38,0,1,6,8,5,0,0,0,0,15617,6.8,17606,194,35,-2139,-1844,19.4,1561.7,95,0,0,8,6,10,1,1,0,0,17756,7.4,19450,200,80,2139,1844,20.0,1775.6
4427502264,1,17,1,0,9,3,9,1,1,0,1,18695,7.2,19263,245,56,4298,2299,24.5,1869.5,13,2,1,3,9,2,1,0,1,0,14397,6.8,16964,190,56,-4298,-2299,19.0,1439.7
4513262976,1,18,5,0,4,1,9,1,1,0,0,15357,6.8,17204,200,59,1273,1061,20.0,1535.7,16,5,1,1,4,2,0,0,0,0,14084,6.4,16143,239,40,-1273,-1061,23.9,1408.4
4521104135,0,14,2,0,4,8,4,1,1,0,0,14439,6.6,16198,196,41,-2975,-2024,19.6,1443.9,39,1,1,8,4,10,0,0,0,0,17414,7.0,18222,235,40,2975,2024,23.5,1741.4
4465279641,0,16,2,1,8,13,4,0,0,0,0,17008,7.2,18223,217,55,-4178,-1302,21.7,1700.8,12,4,0,13,8,13,1,1,0,1,21186,7.4,19525,219,40,4178,1302,21.9,2118.6
4484240174,1,36,2,1,8,2,10,2,1,1,0,17878,6.8,18056,216,52,4347,2472,21.6,1787.8,56,1,0,2,8,2,0,0,0,0,13531,6.2,15584,179,48,-4347,-2472,17.9,1353.1
4516052882,0,12,4,1,7,11,7,0,0,0,0,15418,6.4,15315,203,31,-3531,-3889,20.3,1541.8,18,4,0,11,7,15,2,1,1,0,18949,7.4,19204,215,48,3531,3889,21.5,1894.9
4513351199,0,16,4,0,5,8,3,1,1,0,0,15307,6.8,17610,227,56,-2576,-2182,22.7,1530.7,16,3,1,8,5,5,0,0,0,0,17883,7.4,19792,249,56,2576,2182,24.9,1788.3
4523772935,1,18,0,1,6,6,5,0,0,0,0,16266,7.0,17321,207,44,927,-58,20.7,1626.6,9,2,0,6,6,4,1,1,0,0,15339,6.8,17379,201,46,-927,58,20.1,1533.9
4477758358,0,15,5,0,6,6,7,0,0,0,0,15800,6.8,17954,203,48,-966,111,20.3,1580.0,19,3,1,6,6,7,0,0,0,0,16766,7.0,17843,220,47,966,-111,22.0,1676.6
4513537755,1,11,3,1,8,3,4,1,1,0,0,17499,7.2,19191,231,44,2644,2337,23.1,1749.9,20,0,0,3,8,2,0,0,0,0,14855,6.6,16854,208,39,-2644,-2337,20.8,1485.5
4440545159,1,15,6,1,10,6,6,0,0,0,0,17332,7.2,19582,235,65,1372,1668,23.5,1733.2,16,0,0,6,10,6,0,0,0,0,15960,7.0,17914,207,48,-1372,-1668,20.7,1596.0
4520393819,0,18,1,0,3,8,7,0,0,0,0,13944,6.6,15850,185,48,-3179,-2574,18.5,1394.4,20,8,1,8,3,7,1,1,0,0,17123,7.0,18424,230,48,3179,2574,23.0,1712.3
4495097170,0,15,2,0,5,11,5,0,0,0,0,15543,6.8,17304,197,44,-3318,-2979,19.7,1554.3,14,1,1,11,5,8,2,1,1,0,18861,7.6,20283,228,60,3318,2979,22.8,1886.1
4493030469,0,13,1,0,8,6,8,0,0,0,0,17251,6.6,17267,192,63,339,876,19.2,1725.1,16,0,1,6,8,7,0,0,0,0,16912,6.4,16391,203,48,-339,-876,20.3,1691.2
4498660251,1,16,3,0,8,6,7,1,1,0,0,17104,7.0,18350,223,64,-111,1062,22.3,1710.4,36,2,1,6,8,8,1,0,1,1,17215,6.8,17288,201,48,111,-1062,20.1,1721.5
4525134229,1,19,2,1,7,1,11,1,1,0,0,17566,7.2,19634,243,56,2821,2755,24.3,1756.6,14,2,0,1,7,3,0,0,0,0,14745,6.8,16879,234,54,-2821,-2755,23.4,1474.5
4521070100,0,14,1,0,8,5,8,0,0,0,0,16945,7.4,18652,218,53,1978,1936,21.8,1694.5,26,1,1,5,8,7,0,0,0,0,14967,6.6,16716,188,44,-1978,-1936,18.8,1496.7
4461214115,1,12,1,1,6,8,5,0,0,0,0,16560,7.0,18074,203,65,-407,-1257,20.3,1656.0,47,2,0,8,6,7,1,1,0,0,16967,7.4,19331,223,52,407,1257,22.3,1696.7
4526588067,1,122,4,0,5,5,7,1,0,1,1,17716,7.0,17963,216,44,8,-625,21.6,1771.6,15,3,1,5,5,4,1,1,0,0,17708,7.2,18588,249,68,-8,625,24.9,1770.8
4527729232,0,36,3,0,4,13,5,0,0,0,0,14478,6.2,14665,171,32,-5087,-4618,17.1,1447.8,40,3,1,13,4,12,0,0,0,0,19565,7.2,19283,199,71,5087,4618,19.9,1956.5
4508411289,1,14,3,0,4,4,4,1,1,0,0,17055,7.2,19132,228,80,1400,488,22.8,1705.5,14,3,1,4,4,3,0,0,0,0,15655,7.2,18644,235,47,-1400,-488,23.5,1565.5
4483768812,1,42,4,0,4,8,7,1,1,0,0,16220,6.8,17447,227,60,-444,-184,22.7,1622.0,58,8,1,8,4,12,0,0,0,0,16664,7.0,17631,212,46,444,184,21.2,1666.4
4487946743,0,15,2,0,7,5,8,1,1,0,0,17049,7.4,20151,223,68,-105,1881,22.3,1704.9,14,3,1,5,7,7,0,0,0,0,17154,7.2,18270,231,41,105,-1881,23.1,1715.4
4487337497,0,13,1,1,6,5,9,1,1,0,0,16995,7.0,18679,230,64,930,567,23.0,1699.5,18,2,0,5,6,3,0,0,0,0,16065,7.0,18112,221,43,-930,-567,22.1,1606.5
4515363790,0,12,3,0,4,6,1,0,0,0,0,13772,6.0,14954,178,28,-3147,-3323,17.8,1377.2,22,1,1,6,4,6,1,0,1,0,16919,7.0,18277,223,52,3147,3323,22.3,1691.9
4521454203,0,54,4,0,3,5,5,0,0,0,0,15238,6.8,16831,209,40,-1314,-1498,20.9,1523.8,17,1,1,5,3,6,0,0,0,0,16552,6.8,18329,226,63,1314,1498,22.6,1655.2
4496715260,1,15,1,1,7,4,10,0,0,0,0,17527,7.0,18186,227,56,1863,464,22.7,1752.7,18,2,0,4,7,6,1,1,0,0,15664,7.0,17722,231,48,-1863,-464,23.1,1566.4
4526372741,1,12,1,1,10,4,9,1,1,0,0,18009,7.4,19630,226,56,3026,1849,22.6,1800.9,35,4,0,4,10,1,0,0,0,0,14983,6.8,17781,205,51,-3026,-1849,20.5,1498.3
4521657785,0,21,4,1,10,6,8,1,1,0,0,17561,6.8,18172,203,56,287,568,20.3,1756.1,17,4,0,6,10,4,0,0,0,0,17274,6.6,17604,228,41,-287,-568,22.8,1727.4
4426241259,1,15,4,1,9,3,17,1,1,0,0,17478,7.2,18671,257,47,1071,107,25.7,1747.8,15,2,0,3,9,1,1,0,1,0,16407,7.0,18564,274,60,-1071,-107,27.4,1640.7
4464439713,1,17,2,1,8,4,7,1,0,1,0,16784,6.6,17242,212,40,1424,1060,21.2,1678.4,13,4,0,4,8,5,0,0,0,0,15360,6.4,16182,180,61,-1424,-1060,18.0,1536.0
4523885762,1,15,0,1,7,5,5,0,0,0,0,16801,7.4,18747,203,64,575,706,20.3,1680.1,15,3,0,5,7,7,1,1,0,0,16226,7.0,18041,214,48,-575,-706,21.4,1622.6
4523035934,1,17,4,0,6,6,6,0,0,0,0,16936,7.2,18646,240,56,272,359,24.0,1693.6,56,2,1,6,6,7,1,1,0,0,16664,6.8,18287,199,68,-272,-359,19.9,1666.4
4527613932,0,12,2,1,6,3,5,0,0,0,0,16007,6.8,17907,221,40,1201,695,22.1,1600.7,12,0,0,3,6,3,1,1,0,0,14806,6.8,17212,209,40,-1201,-695,20.9,1480.6
4462632051,1,48,4,1,6,6,9,1,1,0,0,16301,6.8,17430,210,51,-303,312,21.0,1630.1,19,6,0,6,6,11,1,0,1,0,16604,6.8,17118,210,59,303,-312,21.0,1660.4
4525010648,1,37,1,0,10,8,10,0,0,0,0,18588,7.2,19735,225,64,2382,2614,22.5,1858.8,16,1,1,8,10,7,0,0,0,0,16206,6.8,17121,192,28,-2382,-2614,19.2,1620.6
4516264231,1,17,4,1,5,9,8,0,0,0,0,16426,7.0,18382,231,60,-642,-397,23.1,1642.6,16,3,0,9,5,6,1,1,0,0,17068,7.0,18779,193,59,642,397,19.3,1706.8
4523752057,0,30,4,0,6,11,8,0,0,0,0,15376,6.6,16758,196,28,-4264,-3932,19.6,1537.6,16,4,1,11,6,6,2,1,1,0,19640,7.4,20690,262,72,4264,3932,26.2,1964.0
4473464467,0,13,1,0,4,11,3,1,1,0,0,15225,6.2,16104,187,45,-5182,-3884,18.7,1522.5,13,1,1,11,4,9,1,0,1,2,20407,7.4,19988,246,53,5182,3884,24.6,2040.7
4512105521,0,16,4,0,9,6,9,1,1,0,0,17059,7.0,18302,214,52,977,1247,21.4,1705.9,16,1,1,6,9,5,0,0,0,0,16082,6.6,17055,203,52,-977,-1247,20.3,1608.2
4492216281,0,20,0,0,6,10,4,0,0,0,0,14626,6.4,16067,154,43,-4726,-2067,15.4,1462.6,11,3,1,10,6,11,1,1,0,1,19352,7.0,18134,224,52,4726,2067,22.4,1935.2
4524326952,1,19,0,0,9,6,9,0,0,0,0,17368,6.8,18134,219,40,280,-1018,21.9,1736.8,15,3,1,6,9,8,0,0,0,0,17088,7.2,19152,227,59,-280,1018,22.7,1708.8
4524327775,1,23,2,1,6,3,8,0,0,0,0,16050,7.0,17867,195,44,2041,1289,19.5,1605.0,37,2,0,3,6,1,0,0,0,0,14009,6.4,16578,202,44,-2041,-1289,20.2,1400.9
4452529666,1,13,1,0,8,5,15,2,1,1,0,17999,7.2,19381,214,82,2711,2160,21.4,1799.9,15,1,1,5,8,3,0,0,0,0,15288,7.0,17221,213,50,-2711,-2160,21.3,1528.8
4521993716,0,13,2,0,7,5,9,0,0,0,0,16542,6.8,17667,214,44,798,-1263,21.4,1654.2,22,2,1,5,7,4,1,1,0,0,15744,7.2,18930,195,76,-798,1263,19.5,1574.4
4526837862,1,14,2,1,4,7,6,1,0,1,0,15289,7.0,16623,210,52,-1041,-1114,21.0,1528.9,10,1,0,7,4,5,1,1,0,0,16330,6.8,17737,196,52,1041,1114,19.6,1633.0
4521767127,1,17,5,1,9,3,7,0,0,0,0,17990,7.0,19289,226,51,2964,2253,22.6,1799.0,17,1,0,3,9,4,1,1,0,0,15026,6.4,17036,232,41,-2964,-2253,23.2,1502.6
4464866964,1,38,2,0,5,4,4,0,0,0,0,15936,7.0,18595,234,47,254,140,23.4,1593.6,15,2,1,4,5,2,1,1,0,0,15682,7.0,18455,205,63,-254,-140,20.5,1568.2
4513247424,1,22,3,1,6,7,4,0,0,0,0,16956,7.2,19155,242,61,-172,594,24.2,1695.6,17,3,0,7,6,10,1,1,0,0,17128,7.2,18561,213,61,172,-594,21.3,1712.8
4500668824,0,50,12,1,6,3,9,1,1,0,0,15958,6.6,17693,213,48,66,-446,21.3,1595.8,37,3,0,3,6,3,0,0,0,0,15892,6.8,18139,254,60,-66,446,25.4,1589.2
4524349618,1,75,3,0,4,6,4,1,1,0,0,15478,6.8,18212,204,60,-2375,-293,20.4,1547.8,16,1,1,6,4,4,0,0,0,1,17853,7.0,18505,236,48,2375,293,23.6,1785.3
4525225774,1,16,2,1,6,4,6,1,0,1,1,18341,7.2,19885,229,76,3347,2958,22.9,1834.1,16,4,0,4,6,8,1,1,0,0,14994,6.6,16927,206,47,-3347,-2958,20.6,1499.4
4509319311,1,18,2,1,8,5,12,1,1,0,0,17846,7.0,18097,192,67,2425,824,19.2,1784.6,15,1,0,5,8,4,1,0,1,0,15421,6.8,17273,215,48,-2425,-824,21.5,1542.1
4477266895,1,23,6,1,15,5,17,0,0,0,0,19074,6.6,17514,191,35,3941,2200,19.1,1907.4,19,5,0,5,15,3,0,0,0,0,15133,6.6,15314,199,40,-3941,-2200,19.9,1513.3
4511303658,0,14,4,0,7,4,7,1,1,0,0,16743,7.2,18562,215,45,1323,457,21.5,1674.3,13,0,1,4,7,8,0,0,0,0,15420,7.0,18105,209,52,-1323,-457,20.9,1542.0
4519890701,0,13,2,1,3,5,3,1,0,1,0,15072,7.0,17479,233,52,-1247,-2320,23.3,1507.2,41,2,0,5,3,6,1,1,0,0,16319,7.4,19799,222,76,1247,2320,22.2,1631.9
4459085850,1,13,1,1,9,8,12,1,1,0,0,18254,7.2,18805,218,52,844,1636,21.8,1825.4,18,1,0,8,9,15,1,0,1,0,17410,6.8,17169,183,52,-844,-1636,18.3,1741.0
4477061244,1,13,2,1,9,5,8,0,0,0,0,18564,7.2,19783,212,60,2005,2005,21.2,1856.4,12,1,0,5,9,7,0,0,0,0,16559,7.2,17778,236,44,-2005,-2005,23.6,1655.9
4522510473,0,138,4,0,6,4,8,0,0,0,0,15096,6.2,15415,199,32,-120,-1620,19.9,1509.6,15,3,1,4,6,2,1,1,0,0,15216,6.4,17035,193,67,120,1620,19.3,1521.6
4502360734,1,14,2,1,3,3,3,0,0,0,0,16213,7.2,18235,247,60,1962,730,24.7,1621.3,15,3,0,3,3,6,1,0,1,0,14251,6.8,17505,212,39,-1962,-730,21.2,1425.1
4525911373,1,26,1,1,15,3,24,2,1,1,2,23701,7.8,21188,239,70,8863,5411,23.9,2370.1,12,1,0,3,15,2,0,0,0,0,14838,6.4,15777,197,44,-8863,-5411,19.7,1483.8
4511067003,1,12,4,0,4,10,2,0,0,0,0,16956,7.2,19562,252,81,-387,1466,25.2,1695.6,16,2,1,10,4,11,1,1,0,0,17343,7.0,18096,236,44,387,-1466,23.6,1734.3
4494477882,1,17,3,1,8,6,8,1,1,0,0,16563,7.2,18469,199,46,498,244,19.9,1656.3,14,2,0,6,8,2,0,0,0,0,16065,7.0,18225,209,41,-498,-244,20.9,1606.5
4516319678,0,15,1,1,6,2,7,1,0,1,0,16583,7.0,18071,244,52,2191,1140,24.4,1658.3,16,4,0,2,6,1,1,1,0,0,14392,6.8,16931,218,52,-2191,-1140,21.8,1439.2
4520301016,0,13,11,0,5,9,6,0,0,0,0,14826,6.8,16490,176,40,-2907,-3389,17.6,1482.6,38,0,1,9,5,2,1,1,0,0,17733,7.4,19879,229,65,2907,3389,22.9,1773.3
4478592146,1,48,4,1,4,2,4,1,1,0,0,15730,6.8,18012,240,55,1383,660,24.0,1573.0,14,2,0,2,4,1,0,0,0,0,14347,6.6,17352,221,56,-1383,-660,22.1,1434.7
4509031908,0,11,1,1,7,10,4,1,1,0,0,16505,6.6,17778,206,39,-1861,-1195,20.6,1650.5,13,0,0,10,7,11,0,0,0,0,18366,7.0,18973,221,44,1861,1195,22.1,1836.6
4527552331,1,36,4,0,11,13,11,0,0,0,0,17166,6.8,17136,165,36,-1030,-319,16.5,1716.6,16,5,1,13,11,8,1,0,1,0,18196,6.6,17455,203,44,1030,319,20.3,1819.6
4468611805,0,17,1,0,6,6,8,2,1,1,0,16207,7.0,17381,211,50,-819,-1829,21.1,1620.7,13,2,1,6,6,3,0,0,0,0,17026,7.0,19210,223,56,819,1829,22.3,1702.6
4464777980,0,19,2,0,5,5,7,1,1,0,0,15051,6.6,16743,188,35,60,323,18.8,1505.1,11,2,1,5,5,4,0,0,0,0,14991,6.8,16420,206,44,-60,-323,20.6,1499.1
4515382430,1,23,5,0,5,8,7,1,0,1,0,16250,6.8,17847,233,52,-964,-202,23.3,1625.0,22,4,1,8,5,7,1,1,0,0,17214,6.8,18049,221,44,964,202,22.1,1721.4
4484624714,0,18,3,1,8,5,5,0,0,0,0,16208,6.4,16287,190,40,-315,-1874,19.0,1620.8,16,3,0,5,8,5,1,1,0,0,16523,7.0,18161,242,58,315,1874,24.2,1652.3
4520654397,1,16,7,1,1,0,1,1,0,1,0,15268,7.2,18685,269,56,296,440,26.9,1526.8,21,2,0,0,1,0,1,1,0,0,14972,7.2,18245,251,71,-296,-440,25.1,1497.2
4521148922,1,16,3,1,9,5,18,2,1,1,1,19011,7.0,17878,201,57,3451,202,20.1,1901.1,46,1,0,5,9,4,0,0,0,0,15560,7.0,17676,224,44,-3451,-202,22.4,1556.0
4524684326,1,17,3,1,6,3,6,1,1,0,0,16628,6.8,17323,230,56,2050,687,23.0,1662.8,16,1,0,3,6,2,0,0,0,0,14578,6.6,16636,195,43,-2050,-687,19.5,1457.8
4524768975,0,15,2,1,10,15,12,0,0,0,0,18051,6.8,17921,201,41,-2224,-2008,20.1,1805.1,15,3,0,15,10,13,1,1,0,0,20275,7.4,19929,226,48,2224,2008,22.6,2027.5
4511899232,1,22,6,0,6,7,6,0,0,0,0,17170,7.0,18110,243,60,959,2183,24.3,1717.0,17,6,1,7,6,10,0,0,0,0,16211,6.4,15927,194,36,-959,-2183,19.4,1621.1
4507827537,0,16,2,0,5,4,4,0,0,0,0,16429,7.0,18899,242,54,-172,1254,24.2,1642.9,18,1,1,4,5,5,0,0,0,0,16601,6.8,17645,219,47,172,-1254,21.9,1660.1
4524698589,1,80,3,1,7,2,7,1,1,0,0,17324,7.2,19349,216,48,3129,2922,21.6,1732.4,18,0,0,2,7,3,0,0,0,0,14195,6.8,16427,208,47,-3129,-2922,20.8,1419.5
4526906717,1,105,6,1,4,3,0,0,0,0,0,15960,7.4,18912,253,60,1479,2350,25.3,1596.0,15,3,0,3,4,3,0,0,0,0,14481,6.4,16562,228,40,-1479,-2350,22.8,1448.1
4499919097,1,17,3,0,7,2,9,0,0,0,0,16454,7.0,18576,207,45,2042,1127,20.7,1645.4,15,2,1,2,7,1,0,0,0,0,14412,6.8,17449,195,72,-2042,-1127,19.5,1441.2
4471718204,1,16,1,1,17,4,20,1,1,0,1,21703,7.2,19827,202,48,7605,3993,20.2,2170.3,15,0,0,4,17,2,1,0,1,0,14098,6.4,15834,177,56,-7605,-3993,17.7,1409.8
4486662543,1,19,2,0,3,6,5,1,0,1,0,14724,6.6,16522,195,52,-1858,-1476,19.5,1472.4,17,1,1,6,3,7,1,1,0,0,16582,7.0,17998,225,52,1858,1476,22.5,1658.2
4417424903,0,10,0,1,8,6,5,0,0,0,0,16293,7.2,18611,218,44,-176,351,21.8,1629.3,14,3,0,6,8,5,0,0,0,0,16469,7.0,18260,203,56,176,-351,20.3,1646.9
4514280719,1,11,3,0,10,6,8,1,0,1,0,18555,7.4,20361,246,52,2488,2722,24.6,1855.5,14,3,1,6,10,6,1,1,0,0,16067,6.8,17639,185,67,-2488,-2722,18.5,1606.7
4510664685,0,13,5,1,5,6,5,0,0,0,0,16312,7.0,18684,239,41,-77,260,23.9,1631.2,97,2,0,6,5,11,1,1,0,0,16389,7.0,18424,230,42,77,-260,23.0,1638.9
4498547883,1,18,3,0,13,7,11,0,0,0,0,19907,7.6,20865,231,52,3079,2098,23.1,1990.7,17,1,1,7,13,7,1,1,0,0,16828,7.0,18767,186,75,-3079,-2098,18.6,1682.8
4448657505,1,129,4,1,8,7,8,1,1,0,0,17526,7.2,18287,220,45,307,-269,22.0,1752.6,43,2,0,7,8,7,0,0,0,0,17219,7.2,18556,225,52,-307,269,22.5,1721.9
4477027360,0,16,4,0,4,6,3,0,0,0,0,15008,6.6,16888,214,38,-1015,-1751,21.4,1500.8,31,3,1,6,4,4,1,1,0,0,16023,6.8,18639,208,59,1015,1751,20.8,1602.3
4498270130,0,39,1,0,3,9,6,0,0,0,0,14515,6.6,16542,175,64,-4152,-1948,17.5,1451.5,18,9,1,9,3,14,1,1,0,0,18667,7.0,18490,253,40,4152,1948,25.3,1866.7
4502309990,0,53,2,1,5,1,8,2,1,1,0,16165,6.8,18233,215,67,1321,1735,21.5,1616.5,14,2,0,1,5,2,0,0,0,0,14844,6.6,16498,245,56,-1321,-1735,24.5,1484.4
4522160607,0,19,3,1,12,8,8,0,0,0,0,19525,7.6,20374,242,50,3224,2800,24.2,1952.5,60,7,0,8,12,10,0,0,0,0,16301,7.0,17574,181,32,-3224,-2800,18.1,1630.1
4462114577,0,36,4,1,5,9,7,0,0,0,0,16942,7.0,17624,227,63,9,-1196,22.7,1694.2,16,1,0,9,5,9,1,1,0,0,16933,6.8,18820,215,47,-9,1196,21.5,1693.3
4470281902,1,17,1,1,8,6,11,0,0,0,0,17791,7.0,18244,216,48,1625,552,21.6,1779.1,16,2,0,6,8,9,1,1,0,0,16166,6.8,17692,215,48,-1625,-552,21.5,1616.6
4523304085,1,20,3,1,6,9,6,2,1,1,0,15874,6.4,16649,195,48,-1806,-2407,19.5,1587.4,21,4,0,9,6,11,0,0,0,0,17680,7.2,19056,228,58,1806,2407,22.8,1768.0
4471123041,0,54,3,0,4,2,6,1,1,0,0,15812,7.0,17882,229,53,1325,479,22.9,1581.2,15,3,1,2,4,1,1,0,1,0,14487,7.0,17403,218,54,-1325,-479,21.8,1448.7
4412895789,0,24,0,0,8,11,9,0,0,0,0,16655,7.0,17831,222,44,-1806,-588,22.2,1665.5,13,3,1,11,8,13,2,1,1,0,18461,7.0,18419,215,55,1806,588,21.5,1846.1
4463542711,1,32,2,1,12,6,12,1,1,0,0,19058,7.2,19575,202,47,3413,2984,20.2,1905.8,16,2,0,6,12,7,0,0,0,0,15645,6.6,16591,210,39,-3413,-2984,21.0,1564.5
4512198304,1,9,1,1,9,8,8,1,0,1,1,18731,6.8,18892,191,57,1601,459,19.1,1873.1,15,0,0,8,9,6,1,1,0,0,17130,7.2,18433,240,44,-1601,-459,24.0,1713.0
4478403685,0,18,2,1,10,8,12,0,0,0,0,17883,6.8,17407,198,40,1485,-264,19.8,1788.3,16,3,0,8,10,10,1,1,0,0,16398,6.8,17671,194,52,-1485,264,19.4,1639.8
4472611324,0,25,7,1,6,3,6,0,0,0,0,15048,7.0,17356,183,34,-1138,-867,18.3,1504.8,17,7,0,3,6,3,1,1,0,0,16186,7.0,18223,253,54,1138,867,25.3,1618.6
4521830295,0,16,2,0,9,18,9,0,0,0,0,16331,6.4,14886,162,31,-3966,-2999,16.2,1633.1,18,2,1,18,9,16,1,0,1,0,20297,6.8,17885,169,38,3966,2999,16.9,2029.7
4527544639,0,50,1,0,8,9,8,0,0,0,0,15372,6.8,16833,161,40,-3616,-3352,16.1,1537.2,12,2,1,9,8,4,1,1,0,0,18988,7.6,20185,248,64,3616,3352,24.8,1898.8
4505905510,1,13,2,1,5,5,5,0,0,0,0,16287,7.0,16978,235,38,1099,-622,23.5,1628.7,12,1,0,5,5,4,0,0,0,0,15188,6.8,17600,183,51,-1099,622,18.3,1518.8
4510707082,1,13,1,1,8,8,7,1,1,0,0,16493,7.0,17450,175,44,-862,-1734,17.5,1649.3,32,2,0,8,8,5,1,0,1,0,17355,7.2,19184,223,55,862,1734,22.3,1735.5
4439674846,0,41,2,1,5,6,3,1,0,1,1,17389,7.4,19074,224,53,760,120,22.4,1738.9,13,3,0,6,5,6,1,1,0,0,16629,7.2,18954,235,57,-760,-120,23.5,1662.9
4489091340,1,18,3,1,4,9,6,0,0,0,0,15445,6.8,17126,225,44,-3056,-2938,22.5,1544.5,43,5,0,9,4,8,1,1,0,0,18501,7.4,20064,221,68,3056,2938,22.1,1850.1
4522097658,1,16,3,1,11,4,11,1,1,0,0,19165,7.4,20050,219,47,4297,2642,21.9,1916.5,16,2,0,4,11,4,0,0,0,0,14868,6.8,17408,177,55,-4297,-2642,17.7,1486.8
4505468000,0,15,2,0,4,7,4,0,0,0,0,15624,6.8,18203,229,58,-1647,-1866,22.9,1562.4,14,8,1,7,4,7,1,1,0,0,17271,7.4,20069,243,58,1647,1866,24.3,1727.1
4512589969,0,16,4,1,5,2,6,0,0,0,0,17126,7.0,19205,249,53,2361,1802,24.9,1712.6,11,7,0,2,5,2,2,1,1,0,14765,6.8,17403,230,52,-2361,-1802,23.0,1476.5
4467164835,1,18,5,0,14,4,21,1,1,0,0,19948,7.4,20064,220,56,4301,3444,22.0,1994.8,66,2,1,4,14,4,0,0,0,0,15647,6.6,16620,205,60,-4301,-3444,20.5,1564.7
4475027319,1,19,2,0,10,4,12,1,1,0,0,18491,7.2,19416,237,55,3517,2881,23.7,1849.1,13,4,1,4,10,4,0,0,0,0,14974,6.8,16535,211,48,-3517,-2881,21.1,1497.4
4505778188,1,15,0,1,7,3,8,0,0,0,0,16702,6.8,17865,203,54,1713,1391,20.3,1670.2,15,4,0,3,7,6,0,0,0,0,14989,6.6,16474,228,42,-1713,-1391,22.8,1498.9
4511396736,0,19,1,0,4,6,5,1,0,1,0,14939,6.6,15632,189,51,-798,-1418,18.9,1493.9,11,3,1,6,4,13,1,1,0,0,15737,6.8,17050,210,50,798,1418,21.0,1573.7
4513442931,0,40,4,1,7,5,9,0,0,0,0,17003,6.6,18007,214,40,1331,1287,21.4,1700.3,16,1,0,5,7,8,0,0,0,0,15672,6.8,16720,190,52,-1331,-1287,19.0,1567.2
4478776750,0,50,4,1,4,4,9,1,1,0,0,15317,6.6,16907,226,52,-1300,-120,22.6,1531.7,18,2,0,4,4,7,1,0,1,1,16617,6.8,17027,211,48,1300,120,21.1,1661.7
4492947311,0,39,2,1,6,8,8,1,0,1,0,16138,6.8,17626,178,52,-1208,-1365,17.8,1613.8,18,5,0,8,6,7,1,1,0,0,17346,7.2,18991,215,60,1208,1365,21.5,1734.6
4527144982,1,51,4,1,7,5,7,0,0,0,0,17549,7.4,19400,239,54,2588,1353,23.9,1754.9,13,1,0,5,7,6,0,0,0,0,14961,6.6,18047,192,50,-2588,-1353,19.2,1496.1
4514246517,0,14,2,0,3,6,3,0,0,0,0,15049,6.8,17845,200,47,-964,-271,20.0,1504.9,18,1,1,6,3,4,2,1,1,0,16013,7.0,18116,196,46,964,271,19.6,1601.3
4511008520,0,17,1,0,2,5,1,1,1,0,0,13352,6.6,16455,188,44,-3059,-2718,18.8,1335.2,12,1,1,5,2,3,1,0,1,0,16411,7.0,19173,252,48,3059,2718,25.2,1641.1
4484373881,0,17,1,1,6,4,8,2,1,1,0,17249,7.0,18964,239,56,1095,768,23.9,1724.9,12,4,0,4,6,6,0,0,0,0,16154,7.0,18196,247,56,-1095,-768,24.7,1615.4
4474429080,0,18,4,0,5,6,5,0,0,0,0,15923,7.0,17907,212,62,-228,-387,21.2,1592.3,20,5,1,6,5,5,1,1,0,0,16151,7.0,18294,230,48,228,387,23.0,1615.1
4525101831,1,22,1,0,9,7,7,0,0,0,0,17518,7.2,19434,212,52,731,1627,21.2,1751.8,13,1,1,7,9,4,1,1,0,0,16787,7.0,17807,192,47,-731,-1627,19.2,1678.7
4520554250,0,21,5,0,7,7,4,0,0,0,0,17319,7.0,18310,253,36,2209,1640,25.3,1731.9,14,6,1,7,7,6,2,1,1,0,15110,6.8,16670,159,49,-2209,-1640,15.9,1511.0
4446053181,1,15,2,0,5,6,8,0,0,0,0,15964,6.8,17988,206,65,-243,860,20.6,1596.4,17,2,1,6,5,8,2,1,1,0,16207,6.6,17128,205,43,243,-860,20.5,1620.7
4499965552,1,18,1,1,10,2,8,1,1,0,1,20127,7.2,19673,251,60,6148,3541,25.1,2012.7,13,2,0,2,10,1,0,0,0,0,13979,6.4,16132,196,50,-6148,-3541,19.6,1397.9
4455324807,1,43,0,0,7,10,5,0,0,0,0,17444,7.2,18454,197,56,-180,-102,19.7,1744.4,17,1,1,10,7,12,2,1,1,0,17624,7.0,18556,204,52,180,102,20.4,1762.4
4524074861,0,15,0,1,7,9,6,0,0,0,0,16070,6.6,16510,199,44,-1923,-1753,19.9,1607.0,17,1,0,9,7,11,0,0,0,0,17993,7.0,18263,211,60,1923,1753,21.1,1799.3
4506779668,0,39,3,0,4,7,4,1,1,0,0,15722,6.8,17329,221,53,-3309,-2741,22.1,1572.2,17,5,1,7,4,9,0,0,0,1,19031,7.4,20070,230,60,3309,2741,23.0,1903.1
4507594036,1,14,1,0,6,8,7,0,0,0,0,15818,6.6,16894,162,53,-1492,-1925,16.2,1581.8,13,2,1,8,6,5,1,1,0,0,17310,7.2,18819,214,56,1492,1925,21.4,1731.0
4500070797,0,14,3,0,5,7,2,0,0,0,0,14318,6.6,16916,180,45,-1575,-1224,18.0,1431.8,14,0,1,7,5,5,1,1,0,0,15893,7.0,18140,193,50,1575,1224,19.3,1589.3
4524997224,0,18,3,0,2,5,1,1,1,0,0,14579,6.8,17772,218,67,-1684,-772,21.8,1457.9,15,3,1,5,2,3,0,0,0,0,16263,7.2,18544,226,64,1684,772,22.6,1626.3
4484833636,1,17,8,1,7,4,11,1,0,1,2,19915,7.2,18674,246,53,5286,3583,24.6,1991.5,17,1,0,4,7,8,1,1,0,0,14629,6.2,15091,154,45,-5286,-3583,15.4,1462.9
4455484504,0,40,2,0,3,4,4,0,0,0,0,15120,6.8,17606,230,48,-1338,-779,23.0,1512.0,19,17,1,4,3,8,1,1,0,0,16458,7.0,18385,234,55,1338,779,23.4,1645.8
4525110974,1,13,3,1,8,3,10,2,1,1,0,16903,7.4,19854,207,63,2524,2733,20.7,1690.3,39,2,0,3,8,1,0,0,0,0,14379,6.8,17121,199,40,-2524,-2733,19.9,1437.9
4496314087,1,17,3,1,9,4,9,1,1,0,0,17284,7.0,18315,238,44,2670,1589,23.8,1728.4,15,3,0,4,9,3,0,0,0,0,14614,6.6,16726,208,42,-2670,-1589,20.8,1461.4
4453463831,0,14,3,1,4,6,4,1,1,0,0,16209,7.2,18802,235,72,-907,-1159,23.5,1620.9,17,5,0,6,4,7,0,0,0,0,17116,7.2,19961,242,62,907,1159,24.2,1711.6
4508799879,0,10,3,0,3,6,5,1,0,1,0,15521,6.6,16916,202,60,-1187,-714,20.2,1552.1,72,1,1,6,3,6,1,1,0,0,16708,7.0,17630,219,53,1187,714,21.9,1670.8
4521976422,1,16,2,0,7,8,5,1,0,1,0,16697,7.4,19017,205,44,-333,1358,20.5,1669.7,19,3,1,8,7,8,1,1,0,0,17030,6.8,17659,222,52,333,-1358,22.2,1703.0
4438463370,1,15,4,1,12,3,8,2,1,1,0,18821,7.4,20341,225,72,5301,5872,22.5,1882.1,14,1,0,3,12,3,0,0,0,0,13520,6.4,14469,167,48,-5301,-5872,16.7,1352.0
4522587007,1,17,2,0,4,7,5,0,0,0,0,16171,7.0,18471,240,57,-758,920,24.0,1617.1,12,1,1,7,4,8,0,0,0,0,16929,6.8,17551,208,57,758,-920,20.8,1692.9
4515342462,0,15,1,0,7,11,7,0,0,0,0,15225,6.4,16334,180,40,-3230,-3243,18.0,1522.5,17,3,1,11,7,7,1,1,0,0,18455,7.2,19577,227,52,3230,3243,22.7,1845.5
4500135002,1,13,2,1,10,8,10,0,0,0,0,17692,7.2,18587,203,63,1018,1319,20.3,1769.2,12,1,0,8,10,10,1,1,0,0,16674,6.8,17268,201,38,-1018,-1319,20.1,1667.4
4452084615,0,19,1,0,3,4,2,0,0,0,0,14317,6.8,17076,224,45,-2155,-1351,22.4,1431.7,20,2,1,4,3,4,1,0,1,0,16472,7.0,18427,239,52,2155,1351,23.9,1647.2
4379951765,0,79,3,0,4,7,4,0,0,0,0,16017,6.6,17524,202,55,-1031,-570,20.2,1601.7,16,1,1,7,4,7,0,0,0,0,17048,7.0,18094,226,52,1031,570,22.6,1704.8
4500695387,1,22,5,0,4,4,4,0,0,0,0,14942,6.6,17678,200,51,-763,395,20.0,1494.2,41,4,1,4,4,9,1,1,0,0,15705,6.8,17283,241,50,763,-395,24.1,1570.5
4514199075,1,18,2,1,4,6,4,0,0,0,0,16317,7.0,17928,228,50,-248,-1557,22.8,1631.7,20,3,0,6,4,4,2,1,1,0,16565,7.2,19485,225,59,248,1557,22.5,1656.5
4519754998,1,27,1,1,6,5,4,0,0,0,0,16789,7.0,19024,218,72,959,917,21.8,1678.9,17,3,0,5,6,5,1,1,0,0,15830,7.0,18107,213,52,-959,-917,21.3,1583.0
4516294607,0,15,1,0,7,8,7,0,0,0,0,15707,6.8,16724,206,38,-968,-1029,20.6,1570.7,18,2,1,8,7,7,2,1,1,0,16675,6.8,17753,218,43,968,1029,21.8,1667.5
4524480433,0,11,3,1,3,10,1,1,1,0,0,13744,6.4,15449,167,50,-4663,-3624,16.7,1374.4,15,2,0,10,3,11,0,0,0,0,18407,7.2,19073,219,44,4663,3624,21.9,1840.7
4497094157,0,45,6,0,7,4,6,0,0,0,0,16258,7.0,18355,207,43,-487,764,20.7,1625.8,17,3,1,4,7,4,1,0,1,1,16745,6.6,17591,207,61,487,-764,20.7,1674.5
4511560979,1,19,2,1,9,7,9,0,0,0,0,17498,7.0,17932,200,42,1023,19,20.0,1749.8,16,2,0,7,9,6,1,0,1,0,16475,6.8,17913,196,32,-1023,-19,19.6,1647.5
4525999060,0,46,2,0,3,6,0,1,0,1,0,14984,7.0,18050,235,64,-1287,-746,23.5,1498.4,19,3,1,6,3,3,1,1,0,0,16271,7.0,18796,237,58,1287,746,23.7,1627.1
4490487724,1,18,1,1,3,7,2,0,0,0,0,15065,6.6,17137,231,50,-2595,-2856,23.1,1506.5,17,8,0,7,3,6,1,0,1,0,17660,7.4,19993,260,51,2595,2856,26.0,1766.0
4524955367,1,17,3,0,2,6,2,1,1,0,0,14341,6.8,17715,233,52,-1929,-680,23.3,1434.1,15,4,1,6,2,8,0,0,0,0,16270,7.0,18395,233,44,1929,680,23.3,1627.0
4452824310,0,13,6,1,5,6,8,2,1,1,0,17035,7.0,18139,230,63,851,327,23.0,1703.5,21,3,0,6,5,6,0,0,0,0,16184,6.6,17812,219,52,-851,-327,21.9,1618.4
4520036166,0,14,2,0,1,11,0,0,0,0,0,13701,6.6,15626,200,48,-4873,-2666,20.0,1370.1,15,1,1,11,1,12,1,1,0,0,18574,7.2,18292,222,46,4873,2666,22.2,1857.4
4463551021,0,17,1,0,2,11,2,0,0,0,0,13714,6.6,16890,201,43,-5129,-3055,20.1,1371.4,13,1,1,11,2,12,1,0,1,0,18843,7.2,19945,250,38,5129,3055,25.0,1884.3
4478110348,0,14,5,1,3,4,2,0,0,0,0,14490,6.8,17534,226,37,-1759,-2019,22.6,1449.0,41,3,0,4,3,1,1,1,0,0,16249,7.2,19553,247,58,1759,2019,24.7,1624.9
4492010722,1,18,0,1,9,5,7,2,1,1,0,16587,7.0,17630,212,44,814,2199,21.2,1658.7,14,2,0,5,9,7,0,0,0,0,15773,6.4,15431,176,48,-814,-2199,17.6,1577.3
4518120419,1,11,2,1,8,3,13,1,1,0,0,18291,7.0,18572,235,52,3222,1012,23.5,1829.1,34,0,0,3,8,2,0,0,0,0,15069,7.2,17560,232,48,-3222,-1012,23.2,1506.9
4489166333,0,15,2,1,5,9,3,0,0,0,0,16452,6.6,17540,232,51,-480,353,23.2,1645.2,15,1,0,9,5,10,0,0,0,0,16932,6.8,17187,192,32,480,-353,19.2,1693.2
4464939561,1,20,0,0,3,6,1,0,0,0,0,13952,6.6,17089,197,44,-2729,-1427,19.7,1395.2,15,2,1,6,3,4,1,1,0,0,16681,7.0,18516,252,56,2729,1427,25.2,1668.1
4487124026,1,21,4,0,7,7,9,0,0,0,0,17251,7.0,19522,225,60,-172,1613,22.5,1725.1,18,3,1,7,7,9,0,0,0,0,17423,6.8,17909,224,48,172,-1613,22.4,1742.3
4511239909,1,39,3,1,6,7,5,1,1,0,0,16688,6.8,17678,223,44,-405,437,22.3,1668.8,17,4,0,7,6,11,0,0,0,0,17093,6.6,17241,205,55,405,-437,20.5,1709.3
4477019326,1,10,3,0,5,5,7,0,0,0,0,16038,7.2,19227,228,54,-844,139,22.8,1603.8,14,3,1,5,5,5,1,1,0,0,16882,7.2,19088,226,68,844,-139,22.6,1688.2
4525118904,1,15,2,1,7,2,8,1,1,0,0,18650,7.4,20329,248,60,3877,1762,24.8,1865.0,51,1,0,2,7,3,0,0,0,0,14773,7.2,18567,220,61,-3877,-1762,22.0,1477.3
4525858898,1,18,1,1,6,7,7,0,0,0,0,16592,7.0,18393,221,44,813,1232,22.1,1659.2,19,4,0,7,6,8,0,0,0,0,15779,7.0,17161,195,47,-813,-1232,19.5,1577.9
4526103377,1,86,2,0,5,6,7,0,0,0,0,16123,6.8,17612,203,60,569,304,20.3,1612.3,15,2,1,6,5,4,1,1,0,0,15554,6.8,17308,181,60,-569,-304,18.1,1555.4
4526253897,0,57,2,1,6,3,10,0,0,0,0,15954,6.8,17647,203,44,534,89,20.3,1595.4,17,1,0,3,6,4,1,1,0,0,15420,6.8,17558,248,45,-534,-89,24.8,1542.0
4519814636,1,19,3,1,5,5,7,1,1,0,0,16345,7.0,17851,230,46,1284,-1614,23.0,1634.5,17,2,0,5,5,3,1,0,1,0,15061,7.2,19465,200,43,-1284,1614,20.0,1506.1
4495693355,0,18,1,0,3,4,1,1,1,0,0,15701,7.0,17966,245,44,826,-382,24.5,1570.1,13,1,1,4,3,6,0,0,0,0,14875,7.0,18348,193,62,-826,382,19.3,1487.5
4492410898,0,16,2,1,7,6,7,0,0,0,0,16440,6.8,17181,197,37,-635,-1449,19.7,1644.0,11,5,0,6,7,8,1,1,0,0,17075,7.0,18630,246,49,635,1449,24.6,1707.5
4516109227,0,13,1,0,6,3,3,1,1,0,0,16658,7.0,18573,251,42,1951,1640,25.1,1665.8,11,1,1,3,6,3,0,0,0,0,14707,6.6,16933,203,50,-1951,-1640,20.3,1470.7
4524409899,0,13,4,1,5,3,7,0,0,0,0,16660,7.2,18967,257,52,1723,970,25.7,1666.0,38,1,0,3,5,5,2,1,1,0,14937,7.0,17997,227,52,-1723,-970,22.7,1493.7
4494787893,0,9,2,1,4,2,0,0,0,0,0,15555,7.4,19704,214,70,737,1094,21.4,1555.5,38,0,0,2,4,2,1,1,0,0,14818,7.2,18610,235,51,-737,-1094,23.5,1481.8
4472625849,0,22,2,0,12,9,10,1,0,1,0,18291,6.8,17873,208,56,1693,1979,20.8,1829.1,12,2,1,9,12,11,0,0,0,0,16598,6.4,15894,180,47,-1693,-1979,18.0,1659.8
4473499451,1,18,5,1,9,4,10,0,0,0,0,18307,7.2,19026,244,49,3113,2284,24.4,1830.7,17,5,0,4,9,3,1,1,0,0,15194,6.4,16742,213,48,-3113,-2284,21.3,1519.4
4470512125,1,18,3,0,8,2,5,1,0,1,0,17235,7.4,19304,227,53,3613,3509,22.7,1723.5,105,3,1,2,8,1,0,0,0,0,13622,6.4,15795,182,50,-3613,-3509,18.2,1362.2
4523349823,1,9,5,0,6,6,6,1,0,1,0,16421,7.4,19037,224,50,961,849,22.4,1642.1,18,0,1,6,6,4,0,0,0,0,15460,7.0,18188,194,48,-961,-849,19.4,1546.0
4478456612,1,40,6,0,4,4,5,0,0,0,0,15894,7.0,18853,223,60,310,536,22.3,1589.4,19,5,1,4,4,4,1,1,0,0,15584,7.0,18317,223,54,-310,-536,22.3,1558.4
4524419928,1,14,1,1,3,4,4,2,1,1,0,15612,7.0,18702,214,72,-1011,-309,21.4,1561.2,18,2,0,4,3,6,0,0,0,0,16623,7.2,19011,239,65,1011,309,23.9,1662.3
4449382907,0,13,1,1,4,4,0,0,0,0,0,14727,7.0,17726,197,52,-1012,-1528,19.7,1472.7,14,2,0,4,4,7,1,1,0,0,15739,7.2,19254,238,56,1012,1528,23.8,1573.9
4496718092,0,13,2,0,6,10,2,0,0,0,0,15485,6.6,17335,191,55,-2650,-388,19.1,1548.5,14,1,1,10,6,10,1,1,0,0,18135,6.8,17723,201,40,2650,388,20.1,1813.5
4462027689,1,16,5,1,6,4,8,1,1,0,1,18395,7.0,19241,236,52,3354,2318,23.6,1839.5,37,3,0,4,6,6,0,0,0,0,15041,6.8,16923,185,52,-3354,-2318,18.5,1504.1
4519166800,1,17,4,0,7,4,6,1,1,0,0,17329,7.4,19569,239,54,1257,1123,23.9,1732.9,14,2,1,4,7,3,0,0,0,0,16072,7.2,18446,242,57,-1257,-1123,24.2,1607.2
4525061543,0,45,18,1,8,9,11,0,0,0,0,17951,6.8,17922,226,39,-194,431,22.6,1795.1,47,4,0,9,8,12,0,0,0,0,18145,6.8,17491,227,48,194,-431,22.7,1814.5
4495666281,1,16,2,1,6,9,5,1,1,0,0,17451,7.0,18484,249,59,-224,-1881,24.9,1745.1,16,2,0,9,6,10,0,0,0,0,17675,7.4,20365,205,38,224,1881,20.5,1767.5
4469723831,1,13,1,1,6,1,2,2,1,1,3,21051,7.4,20745,276,70,8776,8348,27.6,2105.1,14,1,0,1,6,1,0,0,0,0,12275,5.4,12397,176,20,-8776,-8348,17.6,1227.5
4516578815,0,46,0,1,8,5,13,0,0,0,0,16384,6.8,16954,218,37,-232,-1633,21.8,1638.4,10,3,0,5,8,3,0,0,0,0,16616,7.2,18587,242,72,232,1633,24.2,1661.6
4489800281,1,9,2,0,6,8,7,0,0,0,0,16730,7.0,17780,208,49,-828,-1255,20.8,1673.0,14,1,1,8,6,7,0,0,0,0,17558,7.2,19035,233,60,828,1255,23.3,1755.8
4494166965,0,18,2,0,10,11,9,1,1,0,0,18445,7.0,18076,199,50,552,-193,19.9,1844.5,13,3,1,11,10,10,0,0,0,0,17893,7.0,18269,207,36,-552,193,20.7,1789.3
4454750369,0,35,3,0,7,10,9,1,1,0,1,18244,7.0,18223,205,60,-173,-989,20.5,1824.4,14,0,1,10,7,9,0,0,0,0,18417,7.0,19212,210,52,173,989,21.0,1841.7
4469837233,1,12,1,1,1,6,1,0,0,0,0,14577,6.8,17474,263,43,-1742,-1210,26.3,1457.7,15,2,0,6,1,6,1,1,0,0,16319,7.0,18684,234,52,1742,1210,23.4,1631.9
4471276142,1,11,3,1,9,7,14,1,1,0,0,17631,7.0,17645,199,38,1328,1043,19.9,1763.1,16,0,0,7,9,7,0,0,0,0,16303,6.6,16602,188,56,-1328,-1043,18.8,1630.3
4516541266,0,51,1,0,2,5,4,1,0,1,0,14772,6.8,17784,214,59,-2395,-2173,21.4,1477.2,15,2,1,5,2,5,1,1,0,0,17167,7.4,19957,258,68,2395,2173,25.8,1716.7
4487004786,0,18,5,0,7,7,7,1,1,0,0,16056,6.6,16268,188,40,-1151,-1924,18.8,1605.6,15,1,1,7,7,14,1,0,1,0,17207,7.0,18192,235,49,1151,1924,23.5,1720.7
4511773311,1,12,1,0,2,3,2,1,1,0,0,13879,6.6,16393,194,44,-1499,-1628,19.4,1387.9,17,5,1,3,2,1,0,0,0,0,15378,7.0,18021,226,40,1499,1628,22.6,1537.8
4524656905,0,16,3,0,9,8,10,1,1,0,0,17586,7.2,18812,227,56,319,1558,22.7,1758.6,15,2,1,8,9,6,0,0,0,0,17267,6.8,17254,232,35,-319,-1558,23.2,1726.7
4488648117,0,26,3,0,4,5,3,0,0,0,0,14925,7.0,18636,218,49,-1375,-850,21.8,1492.5,16,7,1,5,4,4,1,1,0,0,16300,7.6,19486,220,76,1375,850,22.0,1630.0
4492722693,1,13,1,1,8,5,8,0,0,0,0,17953,6.8,18196,218,59,3363,2997,21.8,1795.3,13,2,0,5,8,9,1,1,0,0,14590,6.4,15199,176,43,-3363,-2997,17.6,1459.0
4452202569,1,53,4,0,7,11,10,0,0,0,0,16308,6.8,16771,189,44,-1751,-2784,18.9,1630.8,40,1,1,11,7,9,1,0,1,0,18059,7.4,19555,200,58,1751,2784,20.0,1805.9
4521438360,1,15,2,1,6,3,3,1,1,0,0,17602,7.4,19787,251,73,2849,1925,25.1,1760.2,39,3,0,3,6,3,0,0,0,0,14753,6.8,17862,196,54,-2849,-1925,19.6,1475.3
4503866171,0,17,2,0,4,9,2,2,1,1,0,14997,6.6,16588,217,48,-2566,-2224,21.7,1499.7,14,4,1,9,4,9,0,0,0,0,17563,7.2,18812,216,48,2566,2224,21.6,1756.3
4510883651,0,18,0,1,6,11,5,0,0,0,0,15246,6.4,15419,151,42,-4370,-4504,15.1,1524.6,16,5,0,11,6,12,1,1,0,0,19616,7.2,19923,235,51,4370,4504,23.5,1961.6
4497827663,1,40,4,0,8,6,8,0,0,0,0,17564,7.2,18892,232,40,1156,916,23.2,1756.4,53,5,1,6,8,5,0,0,0,0,16408,7.0,17976,211,65,-1156,-916,21.1,1640.8
4501224571,0,13,1,0,5,8,3,0,0,0,0,15318,7.0,18578,200,48,-1086,646,20.0,1531.8,35,1,1,8,5,8,2,1,1,0,16404,6.8,17932,194,43,1086,-646,19.4,1640.4
4526299418,0,11,6,1,7,11,10,1,0,1,1,18142,6.8,16864,209,43,1051,-1411,20.9,1814.2,20,3,0,11,7,8,1,1,0,0,17091,7.2,18275,183,48,-1051,1411,18.3,1709.1
4498209347,1,29,2,1,3,3,2,2,1,1,0,15661,7.0,18396,225,64,-643,-1199,22.5,1566.1,15,3,0,3,3,5,0,0,0,0,16304,7.2,19595,256,71,643,1199,25.6,1630.4
4489494110,1,25,5,1,14,3,15,0,0,0,0,20317,7.4,20330,212,54,6153,3916,21.2,2031.7,13,4,0,3,14,4,0,0,0,0,14164,6.4,16414,196,45,-6153,-3916,19.6,1416.4
4518472442,0,17,3,0,8,4,8,1,1,0,0,17415,6.8,16774,232,48,2791,1911,23.2,1741.5,40,4,1,4,8,8,0,0,0,0,14624,6.2,14863,205,26,-2791,-1911,20.5,1462.4
4526061513,1,14,2,0,9,10,9,1,0,1,0,17840,7.2,19273,226,45,-359,784,22.6,1784.0,16,3,1,10,9,9,1,1,0,0,18199,7.0,18489,207,50,359,-784,20.7,1819.9
4521354990,0,10,0,0,7,9,4,0,0,0,0,15933,6.8,16916,221,48,-1790,-1980,22.1,1593.3,14,3,1,9,7,10,1,1,0,0,17723,7.2,18896,223,64,1790,1980,22.3,1772.3
4501002561,1,15,2,1,7,3,5,1,0,1,0,16178,7.2,18656,216,47,381,203,21.6,1617.8,16,1,0,3,7,3,1,1,0,0,15797,7.0,18453,253,52,-381,-203,25.3,1579.7
4459705547,1,39,3,0,9,5,8,1,1,0,0,16997,7.8,20958,222,52,1176,3600,22.2,1699.7,11,2,1,5,9,9,1,0,1,0,15821,6.8,17358,196,46,-1176,-3600,19.6,1582.1
4517806218,0,16,2,1,9,8,7,1,0,1,0,17347,7.0,18573,202,62,-1144,480,20.2,1734.7,13,5,0,8,9,11,1,1,0,1,18491,7.0,18093,199,45,1144,-480,19.9,1849.1
4449452387,0,18,1,0,5,5,1,1,1,0,1,15891,6.4,15926,179,36,-498,-1785,17.9,1589.1,13,3,1,5,5,4,0,0,0,0,16389,6.8,17711,196,55,498,1785,19.6,1638.9
4526256395,0,37,3,0,1,6,1,1,0,1,0,14308,6.8,17611,235,48,-2634,-1282,23.5,1430.8,19,3,1,6,1,9,1,1,0,0,16942,7.4,18893,247,66,2634,1282,24.7,1694.2
4524445302,1,18,1,0,12,9,10,0,0,0,0,17597,6.4,15938,143,48,905,1054,14.3,1759.7,12,3,1,9,12,9,0,0,0,0,16692,6.2,14884,181,40,-905,-1054,18.1,1669.2
4505233035,1,39,0,1,5,7,4,0,0,0,0,16247,6.8,17790,189,52,-820,-575,18.9,1624.7,16,5,0,7,5,6,1,1,0,0,17067,7.0,18365,222,57,820,575,22.2,1706.7
4523917327,1,15,2,0,16,10,17,2,1,1,0,20344,7.0,18646,193,48,3175,1975,19.3,2034.4,43,1,1,10,16,11,0,0,0,0,17169,6.6,16671,162,32,-3175,-1975,16.2,1716.9
4524440792,0,15,4,0,3,6,4,0,0,0,0,14879,6.6,16931,217,35,-1775,-722,21.7,1487.9,35,3,1,6,3,4,0,0,0,0,16654,6.8,17653,215,56,1775,722,21.5,1665.4
4522525839,0,15,3,1,6,6,6,0,0,0,0,17256,7.0,18564,236,47,823,-164,23.6,1725.6,15,2,0,6,6,7,0,0,0,0,16433,7.0,18728,230,48,-823,164,23.0,1643.3
4450742884,0,14,3,0,4,2,5,1,0,1,0,16247,7.4,19687,226,72,1032,1098,22.6,1624.7,16,0,1,2,4,2,1,1,0,0,15215,7.0,18589,243,68,-1032,-1098,24.3,1521.5
4472377536,1,14,3,0,6,4,6,1,1,0,0,16416,7.4,19684,211,60,1177,1161,21.1,1641.6,14,0,1,4,6,2,0,0,0,0,15239,7.0,18523,204,71,-1177,-1161,20.4,1523.9
4506887349,1,14,7,0,3,2,3,1,1,0,0,16075,7.2,19032,251,63,597,559,25.1,1607.5,15,4,1,2,3,3,0,0,0,0,15478,7.0,18473,244,44,-597,-559,24.4,1547.8
4511761586,1,45,5,0,6,7,8,1,1,0,0,17046,7.4,19783,217,67,307,2085,21.7,1704.6,16,7,1,7,6,7,0,0,0,0,16739,7.0,17698,256,40,-307,-2085,25.6,1673.9
4501004124,1,18,2,1,8,2,9,1,0,1,1,18188,7.0,18675,208,49,3263,1440,20.8,1818.8,16,3,0,2,8,2,1,1,0,0,14925,6.8,17235,200,68,-3263,-1440,20.0,1492.5
4503476670,1,19,3,1,4,4,3,0,0,0,0,16621,6.8,18305,255,50,875,-391,25.5,1662.1,15,4,0,4,4,7,0,0,0,0,15746,7.0,18696,238,65,-875,391,23.8,1574.6
4516768381,1,19,3,1,6,10,6,1,0,1,0,15826,7.0,17062,196,42,-2296,-1677,19.6,1582.6,16,5,0,10,6,9,1,1,0,0,18122,6.8,18739,243,45,2296,1677,24.3,1812.2
4517495714,0,18,3,0,3,7,3,0,0,0,0,15355,6.6,17119,204,43,-2215,-2114,20.4,1535.5,16,2,1,7,3,8,2,1,1,0,17570,7.2,19233,240,65,2215,2114,24.0,1757.0
4513214644,0,15,2,0,1,8,1,0,0,0,0,13129,6.6,16126,184,43,-4800,-1308,18.4,1312.9,18,3,1,8,1,10,0,0,0,0,17929,7.0,17434,218,48,4800,1308,21.8,1792.9
4501540670,1,79,2,1,7,7,4,0,0,0,1,18053,7.4,19492,230,41,891,1526,23.0,1805.3,14,1,0,7,7,11,1,1,0,0,17162,7.0,17966,202,54,-891,-1526,20.2,1716.2
4455545387,0,14,1,0,3,11,4,0,0,0,0,14341,6.6,16688,184,64,-5295,-3863,18.4,1434.1,18,3,1,11,3,10,1,1,0,0,19636,7.6,20551,260,64,5295,3863,26.0,1963.6
4524695455,0,37,3,0,3,7,0,0,0,0,0,13967,7.0,16908,197,48,-2681,-834,19.7,1396.7,13,4,1,7,3,6,1,1,0,0,16648,6.6,17742,193,61,2681,834,19.3,1664.8
4523788727,1,13,1,1,12,9,18,0,0,0,0,18748,6.8,17354,195,45,1212,77,19.5,1874.8,13,1,0,9,12,8,1,1,0,0,17536,7.0,17277,193,52,-1212,-77,19.3,1753.6
4523069328,1,17,3,1,5,3,9,1,1,0,0,16123,6.6,17197,204,50,593,-702,20.4,1612.3,12,3,0,3,5,2,0,0,0,0,15530,7.0,17899,238,60,-593,702,23.8,1553.0
4518264766,1,16,5,1,12,1,24,1,1,0,0,20289,7.2,20144,245,48,7039,4860,24.5,2028.9,54,1,0,1,12,1,0,0,0,0,13250,6.4,15284,152,60,-7039,-4860,15.2,1325.0
4508242433,1,84,3,1,7,2,9,1,1,0,0,16683,7.2,19168,223,60,1828,2134,22.3,1668.3,17,1,0,2,7,4,0,0,0,0,14855,6.8,17034,224,44,-1828,-2134,22.4,1485.5
4494291164,0,17,1,0,6,4,7,0,0,0,0,16091,7.0,18518,238,38,356,122,23.8,1609.1,14,4,1,4,6,4,1,1,0,0,15735,7.0,18396,217,64,-356,-122,21.7,1573.5
4483736284,0,93,4,0,8,8,8,1,0,1,0,18683,7.2,19031,218,52,1874,1408,21.8,1868.3,16,4,1,8,8,8,1,1,0,0,16809,6.8,17623,215,44,-1874,-1408,21.5,1680.9
4468006580,0,17,0,0,4,10,10,0,0,0,0,15064,6.2,14203,141,40,-5181,-5072,14.1,1506.4,17,2,1,10,4,9,2,1,1,1,20245,7.4,19275,240,60,5181,5072,24.0,2024.5
4500335888,1,14,2,0,7,4,5,1,1,0,0,17052,7.2,19250,234,64,1648,1881,23.4,1705.2,16,3,1,4,7,4,0,0,0,0,15404,6.6,17369,223,38,-1648,-1881,22.3,1540.4
4461986866,0,86,3,1,6,4,10,0,0,0,0,17275,7.2,19289,241,44,1702,1352,24.1,1727.5,14,1,0,4,6,4,1,1,0,0,15573,6.8,17937,234,60,-1702,-1352,23.4,1557.3
4508403926,0,13,3,0,5,5,3,1,0,1,0,15226,6.6,17298,213,55,-521,-1275,21.3,1522.6,11,2,1,5,5,3,1,1,0,0,15747,7.2,18573,236,48,521,1275,23.6,1574.7
4457117855,1,21,4,1,11,9,13,1,1,0,0,19236,7.4,20585,231,48,2249,2480,23.1,1923.6,16,2,0,9,11,8,0,0,0,0,16987,7.0,18105,219,40,-2249,-2480,21.9,1698.7
4475415564,0,24,1,0,9,5,4,1,0,1,0,17535,7.2,19338,236,60,1782,2856,23.6,1753.5,13,2,1,5,9,6,1,1,0,0,15753,6.8,16482,207,40,-1782,-2856,20.7,1575.3
4491456543,1,20,5,1,10,1,15,1,1,0,0,18795,7.4,20241,260,43,4498,3370,26.0,1879.5,22,3,0,1,10,2,0,0,0,0,14297,6.4,16871,226,48,-4498,-3370,22.6,1429.7
4524511499,0,19,6,1,11,8,9,0,0,0,0,18475,7.4,19732,196,47,1761,1895,19.6,1847.5,19,3,0,8,11,9,1,1,0,0,16714,6.8,17837,196,52,-1761,-1895,19.6,1671.4
4522255964,1,15,1,0,6,7,5,1,0,1,0,16461,7.0,18295,173,64,-667,1243,17.3,1646.1,17,3,1,7,6,9,0,0,0,0,17128,6.6,17052,224,39,667,-1243,22.4,1712.8
4522145954,0,10,4,0,1,6,0,1,1,0,0,13480,6.4,16396,215,52,-3137,-2097,21.5,1348.0,22,1,1,6,1,10,0,0,0,0,16617,7.0,18493,233,49,3137,2097,23.3,1661.7
4517910135,0,40,3,0,4,10,4,1,1,0,0,15494,6.8,17574,211,44,-2846,-2039,21.1,1549.4,13,5,1,10,4,12,0,0,0,0,18340,7.4,19613,213,44,2846,2039,21.3,1834.0
4458968842,1,13,3,0,7,10,6,1,0,1,0,16861,6.8,17932,184,35,-1255,-254,18.4,1686.1,85,1,1,10,7,10,0,0,0,0,18116,7.2,18186,195,48,1255,254,19.5,1811.6
4476285396,0,15,3,1,3,7,2,0,0,0,0,14756,6.6,16229,226,48,-2175,-2386,22.6,1475.6,15,3,0,7,3,9,0,0,0,0,16931,7.2,18615,233,50,2175,2386,23.3,1693.1
4525381910,0,15,2,0,7,10,2,1,1,0,0,17093,7.0,18200,217,60,-492,175,21.7,1709.3,12,1,1,10,7,10,0,0,0,0,17585,7.0,18025,214,39,492,-175,21.4,1758.5
4503699941,0,18,1,1,8,7,11,1,1,0,0,16465,6.6,17106,215,28,84,-1185,21.5,1646.5,18,3,0,7,8,5,0,0,0,0,16381,7.2,18291,203,51,-84,1185,20.3,1638.1
4470994961,0,27,5,0,8,13,8,0,0,0,0,17238,7.0,17907,204,49,-2693,-709,20.4,1723.8,15,4,1,13,8,9,0,0,0,0,19931,7.2,18616,228,49,2693,709,22.8,1993.1
4517169026,1,11,1,1,11,5,12,2,1,1,1,19696,7.2,18881,222,48,3802,1762,22.2,1969.6,21,0,0,5,11,6,0,0,0,0,15894,6.8,17119,209,60,-3802,-1762,20.9,1589.4
4516781152,0,12,4,1,7,4,5,1,1,0,0,17214,7.0,19173,235,48,1746,2273,23.5,1721.4,14,4,0,4,7,6,0,0,0,0,15468,6.8,16900,205,56,-1746,-2273,20.5,1546.8
4510820768,1,11,0,1,7,2,7,1,1,0,0,18117,7.4,19804,236,72,5779,5212,23.6,1811.7,17,0,0,2,7,0,0,0,0,0,12338,5.6,14592,197,8,-5779,-5212,19.7,1233.8
4413539086,1,23,4,1,11,9,12,1,0,1,1,19858,7.4,19501,216,54,3335,2786,21.6,1985.8,17,3,0,9,11,12,1,1,0,0,16523,6.4,16715,168,46,-3335,-2786,16.8,1652.3
4469859843,0,15,3,0,6,6,4,1,1,0,0,15412,6.8,17010,197,48,-886,-476,19.7,1541.2,16,3,1,6,6,8,0,0,0,0,16298,6.8,17486,205,52,886,476,20.5,1629.8
4522610884,1,23,1,0,7,3,10,1,1,0,0,17146,7.2,19310,227,63,2072,2367,22.7,1714.6,15,3,1,3,7,5,0,0,0,0,15074,6.8,16943,241,49,-2072,-2367,24.1,1507.4
4520348374,1,24,3,1,6,6,12,0,0,0,1,17552,6.8,16611,201,45,1189,-821,20.1,1755.2,97,5,0,6,6,5,1,0,1,0,16363,6.8,17432,191,55,-1189,821,19.1,1636.3
4407377509,1,30,10,1,15,7,15,2,1,1,0,20822,6.8,18683,237,53,5040,2681,23.7,2082.2,20,4,0,7,15,8,0,0,0,0,15782,6.4,16002,187,26,-5040,-2681,18.7,1578.2
4517700680,1,55,2,1,7,2,12,1,1,0,0,17340,7.2,19234,229,52,3125,1784,22.9,1734.0,16,1,0,2,7,2,0,0,0,0,14215,6.8,17450,219,50,-3125,-1784,21.9,1421.5
4525299931,0,19,5,1,6,7,8,1,0,1,0,16604,7.0,18077,235,40,-754,-157,23.5,1660.4,26,2,0,7,6,9,0,0,0,0,17358,6.8,18234,243,39,754,157,24.3,1735.8
4486569835,0,17,3,0,2,6,1,0,0,0,0,14207,6.6,16373,211,48,-2723,-1062,21.1,1420.7,20,1,1,6,2,7,1,1,0,0,16930,6.8,17435,208,57,2723,1062,20.8,1693.0
4511924460,1,17,3,1,9,8,10,0,0,0,0,17875,6.8,17347,212,45,1171,-841,21.2,1787.5,15,3,0,8,9,11,0,0,0,0,16704,7.2,18188,190,49,-1171,841,19.0,1670.4
4484101947,0,14,1,1,2,5,2,0,0,0,0,14985,7.0,17710,224,60,-1522,-1437,22.4,1498.5,14,2,0,5,2,5,1,1,0,0,16507,7.2,19147,253,56,1522,1437,25.3,1650.7
4470054451,1,12,4,1,10,4,14,1,1,0,0,18374,7.6,20120,229,51,3823,3324,22.9,1837.4,15,2,0,4,10,4,0,0,0,0,14551,6.6,16796,176,52,-3823,-3324,17.6,1455.1
4492470174,1,37,3,1,8,0,9,1,1,0,0,16977,7.4,19499,199,39,3115,2163,19.9,1697.7,14,1,0,0,8,0,0,0,0,0,13862,6.8,17336,217,67,-3115,-2163,21.7,1386.2
4525186736,0,14,3,0,4,7,6,0,0,0,0,15706,7.0,17720,244,46,-1992,-1588,24.4,1570.6,43,3,1,7,4,11,2,1,1,0,17698,7.2,19308,256,56,1992,1588,25.6,1769.8
4471395182,1,17,2,0,13,12,13,0,0,0,0,19714,7.2,18151,186,40,1460,2108,18.6,1971.4,15,1,1,12,13,13,0,0,0,0,18254,6.6,16043,200,35,-1460,-2108,20.0,1825.4
4500463152,0,18,1,0,2,11,4,0,0,0,0,14023,6.4,15096,187,59,-4659,-3268,18.7,1402.3,15,9,1,11,2,18,1,1,0,0,18682,7.2,18364,225,44,4659,3268,22.5,1868.2
4495526731,0,12,2,1,8,5,7,1,0,1,0,17697,7.2,18512,203,59,2682,2118,20.3,1769.7,15,0,0,5,8,5,1,1,0,0,15015,6.6,16394,165,50,-2682,-2118,16.5,1501.5
4508792949,1,11,2,1,11,4,12,2,1,1,0,17970,7.2,19866,208,64,2003,2155,20.8,1797.0,20,1,0,4,11,4,0,0,0,0,15967,7.0,17711,230,54,-2003,-2155,23.0,1596.7
4523809434,0,76,6,0,5,5,4,1,1,0,0,16203,7.0,18321,228,51,2,-365,22.8,1620.3,19,5,1,5,5,6,0,0,0,0,16201,7.0,18686,228,53,-2,365,22.8,1620.1
4466140539,0,15,0,1,2,5,4,0,0,0,0,14635,7.0,17734,235,54,-1478,-1388,23.5,1463.5,16,0,0,5,2,2,0,0,0,0,16113,7.2,19122,246,67,1478,1388,24.6,1611.3
4508109073,1,17,1,1,5,6,4,1,0,1,0,17146,7.0,19051,240,67,954,1154,24.0,1714.6,23,4,0,6,5,8,1,1,0,0,16192,7.0,17897,212,50,-954,-1154,21.2,1619.2
4523058868,0,15,5,0,5,5,7,0,0,0,0,15799,7.0,17703,225,49,56,-694,22.5,1579.9,37,2,1,5,5,4,1,1,0,0,15743,7.2,18397,208,59,-56,694,20.8,1574.3
4525314215,0,16,2,1,5,4,2,0,0,0,0,15372,7.0,17632,228,48,-443,-732,22.8,1537.2,44,5,0,4,5,3,0,0,0,0,15815,7.2,18364,237,56,443,732,23.7,1581.5
4465315065,0,21,4,0,2,9,1,0,0,0,0,13709,6.4,15514,199,40,-4681,-2497,19.9,1370.9,18,4,1,9,2,18,1,1,0,0,18390,7.0,18011,230,51,4681,2497,23.0,1839.0
4524856340,1,25,3,1,8,5,9,1,1,0,0,17265,6.8,17683,233,43,1726,1423,23.3,1726.5,16,3,0,5,8,11,0,0,0,0,15539,6.4,16260,192,48,-1726,-1423,19.2,1553.9
4487682437,1,15,2,0,4,8,4,1,0,1,0,15658,6.6,17351,222,42,-1624,-2019,22.2,1565.8,16,1,1,8,4,8,1,1,0,0,17282,7.4,19370,207,61,1624,2019,20.7,1728.2
4521179969,0,16,1,0,9,12,13,0,0,0,0,17867,6.6,17671,218,49,-1354,-798,21.8,1786.7,15,6,1,12,9,23,0,0,0,0,19221,7.2,18469,214,42,1354,798,21.4,1922.1
4515398027,1,14,4,0,9,6,5,1,0,1,0,17025,7.4,19492,214,52,1399,2616,21.4,1702.5,37,3,1,6,9,5,0,0,0,0,15626,6.6,16876,181,45,-1399,-2616,18.1,1562.6
4526934596,1,17,5,1,6,3,6,0,0,0,0,17854,7.6,20729,260,80,3215,3092,26.0,1785.4,16,2,0,3,6,3,0,0,0,0,14639,6.6,17637,194,55,-3215,-3092,19.4,1463.9
4502665532,1,14,2,1,9,11,12,0,0,0,0,17140,6.6,16531,167,30,-791,-961,16.7,1714.0,16,2,0,11,9,11,0,0,0,0,17931,7.0,17492,214,40,791,961,21.4,1793.1
4501265779,0,12,2,0,8,6,7,0,0,0,0,16793,6.8,17595,210,36,115,-80,21.0,1679.3,14,3,1,6,8,6,1,1,0,0,16678,6.8,17675,238,41,-115,80,23.8,1667.8
4449098612,1,13,2,1,10,6,12,1,1,0,0,18516,7.0,19255,240,58,2019,674,24.0,1851.6,105,1,0,6,10,8,0,0,0,0,16497,7.2,18581,214,49,-2019,-674,21.4,1649.7
4527621723,1,46,0,1,10,2,7,2,1,1,3,19557,7.0,18070,191,51,4380,3242,19.1,1955.7,9,2,0,2,10,4,0,0,0,1,15177,6.0,14828,184,49,-4380,-3242,18.4,1517.7
4526732497,1,16,2,1,11,6,9,1,1,0,0,18445,7.2,19242,218,42,2691,2052,21.8,1844.5,18,0,0,6,11,5,0,0,0,0,15754,6.6,17190,205,40,-2691,-2052,20.5,1575.4
4521632653,1,10,4,0,9,5,12,1,1,0,0,17881,7.2,19236,238,43,1867,1838,23.8,1788.1,15,1,1,5,9,4,0,0,0,0,16014,6.6,17398,205,72,-1867,-1838,20.5,1601.4
4515527726,1,39,1,0,7,6,6,0,0,0,0,17605,7.4,19964,254,64,1564,668,25.4,1760.5,17,2,1,6,7,3,1,1,0,0,16041,7.2,19296,214,44,-1564,-668,21.4,1604.1
4459452565,1,19,0,0,2,4,2,1,1,0,0,14707,7.0,18199,209,64,-410,-194,20.9,1470.7,14,2,1,4,2,3,0,0,0,0,15117,7.0,18393,201,52,410,194,20.1,1511.7
4520686446,0,15,4,0,6,4,10,1,1,0,0,16386,6.6,17424,216,45,742,-654,21.6,1638.6,19,2,1,4,6,3,0,0,0,0,15644,6.8,18078,255,37,-742,654,25.5,1564.4
4510518816,0,15,2,0,1,3,3,0,0,0,0,14626,6.6,17441,229,56,-1547,-916,22.9,1462.6,15,2,1,3,1,4,2,1,1,0,16173,7.2,18357,246,60,1547,916,24.6,1617.3
4498726341,1,18,3,1,12,5,6,0,0,0,0,18967,7.6,19855,240,48,3595,2595,24.0,1896.7,13,1,0,5,12,3,1,1,0,0,15372,6.8,17260,217,56,-3595,-2595,21.7,1537.2
4513650091,0,19,3,1,8,3,4,1,0,1,1,19224,7.6,20086,225,56,4674,2219,22.5,1922.4,34,3,0,3,8,4,1,1,0,0,14550,7.0,17867,189,64,-4674,-2219,18.9,1455.0
4524322157,0,15,3,0,4,9,6,0,0,0,0,14693,6.6,15883,169,41,-3874,-2423,16.9,1469.3,15,2,1,9,4,13,0,0,0,0,18567,7.0,18306,223,43,3874,2423,22.3,1856.7
4499941811,1,11,1,1,8,11,6,1,1,0,0,16836,6.6,16495,215,41,-1521,-2096,21.5,1683.6,18,3,0,11,8,12,0,0,0,0,18357,7.0,18591,215,51,1521,2096,21.5,1835.7
4523296034,0,41,4,0,4,12,4,0,0,0,0,14957,6.8,17705,173,63,-3881,-447,17.3,1495.7,17,3,1,12,4,12,0,0,0,0,18838,7.0,18152,223,44,3881,447,22.3,1883.8
4526452438,0,18,1,1,4,7,2,0,0,0,0,16061,7.0,17642,230,52,-717,-997,23.0,1606.1,15,6,0,7,4,8,1,1,0,0,16778,7.0,18639,236,56,717,997,23.6,1677.8
4519370242,0,10,1,0,9,8,8,1,1,0,0,16732,6.8,16963,208,32,-496,-1184,20.8,1673.2,14,0,1,8,9,9,0,0,0,0,17228,7.0,18147,186,51,496,1184,18.6,1722.8
4468739944,1,17,2,0,8,5,16,1,1,0,0,16291,6.8,16847,179,42,478,1166,17.9,1629.1,20,4,1,5,8,8,0,0,0,0,15813,6.4,15681,205,40,-478,-1166,20.5,1581.3
4484044944,0,88,1,0,4,11,9,0,0,0,0,16121,6.6,16956,169,65,-1587,-1578,16.9,1612.1,14,2,1,11,4,12,1,1,0,0,17708,6.8,18534,221,40,1587,1578,22.1,1770.8
4500454645,1,17,2,1,9,4,5,1,1,0,0,18130,7.2,19017,206,75,3154,1720,20.6,1813.0,13,1,0,4,9,1,1,0,1,0,14976,6.6,17297,194,52,-3154,-1720,19.4,1497.6
4455272131,0,37,4,0,7,7,8,1,1,0,0,17114,7.0,18783,210,41,-218,-840,21.0,1711.4,11,11,1,7,7,6,0,0,0,0,17332,7.4,19623,226,71,218,840,22.6,1733.2
4518164964,1,16,1,0,8,2,9,1,1,0,0,17511,7.6,19617,220,60,2745,1800,22.0,1751.1,15,3,1,2,8,0,0,0,0,0,14766,6.8,17817,235,56,-2745,-1800,23.5,1476.6
4495172463,1,12,0,0,4,6,5,0,0,0,0,15154,6.6,17363,170,56,-2642,-1908,17.0,1515.4,16,2,1,6,4,7,1,1,0,0,17796,7.2,19271,258,64,2642,1908,25.8,1779.6
4526793849,1,11,2,0,8,4,2,2,1,1,1,17696,7.2,18812,224,56,1786,2804,22.4,1769.6,18,3,1,4,8,7,0,0,0,0,15910,6.4,16008,200,52,-1786,-2804,20.0,1591.0
4522436299,0,15,8,1,2,5,3,0,0,0,0,15205,6.6,16968,248,44,-977,-1320,24.8,1520.5,23,3,0,5,2,8,0,0,0,0,16182,7.0,18288,186,64,977,1320,18.6,1618.2
4492336087,1,35,0,0,3,6,4,1,1,0,0,14798,6.8,16659,179,54,-2402,-1757,17.9,1479.8,14,0,1,6,3,7,0,0,0,0,17200,6.8,18416,227,52,2402,1757,22.7,1720.0
4437610399,0,53,1,0,7,7,9,1,1,0,0,17220,7.2,18678,202,64,135,794,20.2,1722.0,15,2,1,7,7,6,0,0,0,0,17085,6.8,17884,228,52,-135,-794,22.8,1708.5
4514358264,1,15,7,0,4,2,3,1,1,0,0,15444,7.0,17833,236,53,1019,708,23.6,1544.4,17,1,1,2,4,0,0,0,0,0,14425,6.6,17125,229,44,-1019,-708,22.9,1442.5
4513970313,0,14,2,0,5,5,4,0,0,0,0,15888,6.8,18144,218,52,-149,645,21.8,1588.8,14,0,1,5,5,4,1,1,0,0,16037,6.6,17499,204,55,149,-645,20.4,1603.7
4522183138,1,18,5,0,9,10,11,2,1,1,1,19003,6.6,16349,226,31,503,-222,22.6,1900.3,19,1,1,10,9,14,0,0,0,0,18500,6.6,16571,209,43,-503,222,20.9,1850.0
4522475191,0,16,3,0,1,5,1,0,0,0,0,13976,6.6,17001,210,58,-2555,-1896,21.0,1397.6,17,4,1,5,1,4,1,1,0,0,16531,7.2,18897,234,68,2555,1896,23.4,1653.1
4526594871,1,38,4,0,5,4,5,0,0,0,0,16508,7.2,18959,230,56,616,1673,23.0,1650.8,14,2,1,4,5,6,0,0,0,0,15892,6.8,17286,238,48,-616,-1673,23.8,1589.2
4525216073,1,18,1,0,6,2,7,1,1,0,0,17062,7.2,20216,235,64,2436,2608,23.5,1706.2,12,5,1,2,6,3,1,0,1,0,14626,7.0,17608,203,60,-2436,-2608,20.3,1462.6
4484049712,0,108,0,1,7,8,7,0,0,0,0,15857,6.6,16404,177,52,-2314,-1903,17.7,1585.7,16,3,0,8,7,8,2,1,1,0,18171,6.8,18307,203,48,2314,1903,20.3,1817.1
4497085879,0,17,2,0,3,8,4,0,0,0,0,16004,7.2,18128,241,64,-966,-455,24.1,1600.4,12,4,1,8,3,9,0,0,0,0,16970,7.2,18583,213,48,966,455,21.3,1697.0
4491776589,1,19,1,0,4,10,3,0,0,0,0,14709,6.4,16206,209,29,-2923,-1079,20.9,1470.9,16,2,1,10,4,12,2,1,1,0,17632,6.8,17285,232,53,2923,1079,23.2,1763.2
4517519722,1,59,2,0,6,5,6,0,0,0,0,16896,7.2,18779,258,46,459,1326,25.8,1689.6,18,4,1,5,6,5,1,1,0,0,16437,7.0,17453,244,44,-459,-1326,24.4,1643.7
4474956980,1,14,2,0,6,3,7,1,1,0,0,16319,7.2,18982,207,59,1589,1075,20.7,1631.9,14,2,1,3,6,2,0,0,0,0,14730,6.6,17907,215,49,-1589,-1075,21.5,1473.0
4517932062,0,14,5,1,7,10,11,1,0,1,0,17759,7.2,18043,246,36,-695,-2159,24.6,1775.9,15,1,0,10,7,6,0,0,0,0,18454,7.4,20202,214,64,695,2159,21.4,1845.4
4449074537,1,19,1,1,11,3,10,2,1,1,1,20259,7.0,19498,238,52,6210,3599,23.8,2025.9,36,3,0,3,11,4,0,0,0,0,14049,6.6,15899,180,52,-6210,-3599,18.0,1404.9
4521939526,0,13,3,0,1,7,0,0,0,0,0,13828,6.6,16964,228,53,-3588,-2501,22.8,1382.8,17,2,1,7,1,6,0,0,0,0,17416,7.2,19465,258,60,3588,2501,25.8,1741.6
4489264481,1,50,2,0,4,3,5,1,1,0,0,15120,6.8,16751,218,48,938,2052,21.8,1512.0,13,1,1,3,4,3,0,0,0,0,14182,5.8,14699,178,46,-938,-2052,17.8,1418.2
4478061108,0,16,4,0,4,9,5,0,0,0,0,15293,6.6,16350,226,46,-2004,-1407,22.6,1529.3,18,4,1,9,4,12,1,0,1,0,17297,6.8,17757,227,39,2004,1407,22.7,1729.7
4503283064,0,14,6,0,1,7,2,0,0,0,0,14333,6.8,17362,222,46,-2671,-1258,22.2,1433.3,14,2,1,7,1,6,1,1,0,0,17004,6.8,18620,224,51,2671,1258,22.4,1700.4
4519585226,1,36,4,1,3,7,3,0,0,0,0,15040,6.6,16582,205,48,-952,-1268,20.5,1504.0,16,2,0,7,3,4,2,1,1,0,15992,7.0,17850,205,44,952,1268,20.5,1599.2
4412946059,1,18,5,1,6,3,4,0,0,0,0,16876,7.0,18664,256,44,2717,2815,25.6,1687.6,17,4,0,3,6,4,0,0,0,0,14159,6.4,15849,205,43,-2717,-2815,20.5,1415.9
4448082269,1,15,7,1,8,4,7,1,0,1,0,17328,7.0,18867,234,56,2156,3157,23.4,1732.8,22,1,0,4,8,8,0,0,0,0,15172,6.2,15710,225,35,-2156,-3157,22.5,1517.2
4511255731,0,12,4,0,1,8,1,1,1,0,0,13591,6.6,16284,201,56,-3754,-2371,20.1,1359.1,13,4,1,8,1,6,0,0,0,0,17345,7.2,18655,256,56,3754,2371,25.6,1734.5
4527204318,0,19,2,0,0,9,0,0,0,0,0,15090,7.0,18031,238,65,-1931,-299,23.8,1509.0,47,5,1,9,0,13,1,1,0,0,17021,7.2,18330,220,44,1931,299,22.0,1702.1
4526260157,1,19,3,0,5,4,5,1,1,0,0,16250,7.2,18390,208,68,1170,1415,20.8,1625.0,17,4,1,4,5,5,0,0,0,0,15080,6.6,16975,205,36,-1170,-1415,20.5,1508.0
4410578219,1,42,5,1,10,5,15,0,0,0,0,18062,6.8,17582,220,33,2301,667,22.0,1806.2,25,5,0,5,10,9,1,1,0,0,15761,6.6,16915,204,52,-2301,-667,20.4,1576.1
4477885741,0,14,2,1,9,9,11,1,1,0,0,16848,6.6,16664,200,35,-973,-2691,20.0,1684.8,17,2,0,9,9,12,0,0,0,0,17821,7.0,19355,214,54,973,2691,21.4,1782.1
4501242317,1,50,5,1,4,0,6,0,0,0,0,17339,7.2,19573,237,74,3652,1943,23.7,1733.9,17,1,0,0,4,0,1,1,0,0,13687,6.8,17630,217,68,-3652,-1943,21.7,1368.7
4502922066,0,12,0,0,3,5,3,1,0,1,0,15861,7.0,19121,270,52,-406,-14,27.0,1586.1,14,1,1,5,3,7,1,1,0,0,16267,7.0,19135,235,56,406,14,23.5,1626.7
4519835151,0,19,3,0,6,9,3,0,0,0,0,16404,6.8,18053,231,40,-554,174,23.1,1640.4,17,4,1,9,6,9,2,1,1,0,16958,6.8,17879,204,41,554,-174,20.4,1695.8
4451639888,0,19,3,1,5,5,6,1,1,0,0,16043,7.0,17912,227,43,-564,-422,22.7,1604.3,21,3,0,5,5,9,1,0,1,0,16607,7.0,18334,236,60,564,422,23.6,1660.7
4502988804,0,14,5,0,2,8,2,0,0,0,0,14177,6.4,15427,196,54,-2115,-2872,19.6,1417.7,18,2,1,8,2,18,1,1,0,0,16292,7.0,18299,200,43,2115,2872,20.0,1629.2
4521254867,0,12,2,1,4,8,4,2,1,1,0,14998,6.6,16127,185,45,-1430,147,18.5,1499.8,14,1,0,8,4,7,0,0,0,0,16428,6.6,15980,196,48,1430,-147,19.6,1642.8
4476326915,0,138,1,0,5,9,3,0,0,0,0,15108,6.8,17595,202,53,-3086,-1701,20.2,1510.8,18,1,1,9,5,8,1,1,0,0,18194,7.2,19296,222,47,3086,1701,22.2,1819.4
4524888423,1,22,3,0,10,3,15,1,1,0,0,18488,7.4,19504,224,49,3096,2404,22.4,1848.8,152,5,1,3,10,2,0,0,0,0,15392,6.8,17100,210,54,-3096,-2404,21.0,1539.2
4502459201,0,15,1,1,3,12,2,0,0,0,0,15853,7.0,18223,220,68,-2388,-1978,22.0,1585.3,18,1,0,12,3,8,2,1,1,0,18241,7.6,20201,205,56,2388,1978,20.5,1824.1
4526621303,0,19,1,0,5,5,4,1,0,1,0,15550,6.8,17793,218,43,-1324,-615,21.8,1555.0,16,4,1,5,5,7,1,1,0,0,16874,6.8,18408,257,64,1324,615,25.7,1687.4
4494508204,1,46,3,1,8,3,9,2,1,1,0,17226,7.2,18458,193,59,2061,1693,19.3,1722.6,17,5,0,3,8,5,0,0,0,0,15165,6.4,16765,220,43,-2061,-1693,22.0,1516.5
4522838213,1,13,2,1,7,0,5,2,1,1,0,17520,7.2,19639,245,63,4228,2880,24.5,1752.0,15,1,0,0,7,0,0,0,0,0,13292,6.6,16759,194,60,-4228,-2880,19.4,1329.2
4521703092,1,16,4,1,8,5,16,1,1,0,0,17616,7.0,18517,235,68,1790,1220,23.5,1761.6,19,4,0,5,8,7,0,0,0,0,15826,6.8,17297,231,36,-1790,-1220,23.1,1582.6
4511649703,1,62,2,1,6,1,8,2,1,1,0,16601,7.0,18535,231,44,1799,442,23.1,1660.1,15,0,0,1,6,1,0,0,0,0,14802,6.8,18093,231,72,-1799,-442,23.1,1480.2
4515422041,0,14,2,1,5,8,4,0,0,0,0,15353,7.0,17812,189,46,-2332,-2671,18.9,1535.3,14,1,0,8,5,5,0,0,0,0,17685,7.6,20483,217,60,2332,2671,21.7,1768.5
4447992971,1,16,2,1,6,4,10,1,1,0,0,16993,7.2,18935,262,57,422,-758,26.2,1699.3,16,3,0,4,6,6,0,0,0,0,16571,7.4,19693,254,60,-422,758,25.4,1657.1
4519907649,1,16,3,1,13,5,18,1,1,0,0,19813,7.0,18543,236,32,4173,1912,23.6,1981.3,14,1,0,5,13,7,0,0,0,0,15640,6.6,16631,167,40,-4173,-1912,16.7,1564.0
4522539833,0,70,11,0,6,5,5,1,0,1,0,16500,6.8,18497,202,47,496,1530,20.2,1650.0,47,1,1,5,6,6,1,1,0,0,16004,6.8,16967,222,40,-496,-1530,22.2,1600.4
4524910590,0,12,2,0,5,8,7,0,0,0,0,15513,6.6,17308,203,43,-1791,507,20.3,1551.3,11,0,1,8,5,14,2,1,1,0,17304,6.8,16801,225,41,1791,-507,22.5,1730.4
4460518084,1,11,3,1,9,7,7,0,0,0,0,18877,7.6,20418,244,67,3094,1999,24.4,1887.7,22,0,0,7,9,6,0,0,0,0,15783,7.2,18419,205,39,-3094,-1999,20.5,1578.3
4525063445,1,15,2,0,8,8,8,1,0,1,0,16836,6.8,17998,228,49,-52,-301,22.8,1683.6,15,2,1,8,8,12,0,0,0,0,16888,7.0,18299,186,52,52,301,18.6,1688.8
4521713895,0,13,1,0,4,9,5,0,0,0,0,14899,6.8,17420,232,32,-3099,-1695,23.2,1489.9,18,4,1,9,4,10,1,1,0,0,17998,7.2,19115,227,56,3099,1695,22.7,1799.8
4517167802,0,33,4,0,7,14,10,0,0,0,0,16204,7.0,17704,182,49,-4473,-3040,18.2,1620.4,17,1,1,14,7,19,1,1,0,0,20677,7.4,20744,237,80,4473,3040,23.7,2067.7
4446215269,0,11,2,0,5,12,4,0,0,0,0,16154,6.8,18081,216,44,-2129,-2255,21.6,1615.4,25,2,1,12,5,12,0,0,0,0,18283,7.4,20336,206,72,2129,2255,20.6,1828.3
4516700251,1,38,5,0,8,3,9,1,1,0,0,17328,7.2,19304,228,69,2357,2202,22.8,1732.8,17,3,1,3,8,2,0,0,0,0,14971,6.8,17102,222,44,-2357,-2202,22.2,1497.1
4510752222,0,16,0,0,2,10,1,0,0,0,0,13268,6.2,15564,170,47,-7839,-3333,17.0,1326.8,14,5,1,10,2,12,2,1,1,2,21107,7.2,18897,253,43,7839,3333,25.3,2110.7
4498664895,0,11,1,0,5,9,5,1,1,0,0,16408,6.8,17435,199,69,-2517,-1199,19.9,1640.8,35,0,1,9,5,12,0,0,0,0,18925,7.2,18634,248,44,2517,1199,24.8,1892.5
4521619561,1,11,2,1,14,6,12,0,0,0,0,19588,7.2,19987,217,45,3864,2988,21.7,1958.8,28,1,0,6,14,10,0,0,0,0,15724,6.8,16999,162,50,-3864,-2988,16.2,1572.4
4524403652,1,12,2,1,7,6,5,1,1,0,0,17051,7.0,18864,246,44,1909,2436,24.6,1705.1,16,0,0,6,7,8,0,0,0,0,15142,6.4,16428,196,40,-1909,-2436,19.6,1514.2
4521842384,1,12,4,0,3,5,6,0,0,0,0,14771,7.0,17825,227,44,-1426,-26,22.7,1477.1,24,2,1,5,3,4,2,1,1,0,16197,7.0,17851,218,52,1426,26,21.8,1619.7
4503510396,0,38,1,0,3,4,4,0,0,0,0,14881,6.6,17401,196,48,-1659,-1134,19.6,1488.1,12,3,1,4,3,5,1,1,0,0,16540,7.2,18535,248,63,1659,1134,24.8,1654.0
4491767708,0,14,7,0,3,8,3,0,0,0,0,15160,7.0,17505,217,52,-2174,-1268,21.7,1516.0,13,3,1,8,3,12,2,1,1,0,17334,7.2,18773,227,64,2174,1268,22.7,1733.4
4518022998,0,23,5,1,7,7,6,0,0,0,0,16313,6.8,16697,201,40,-1249,-3078,20.1,1631.3,17,8,0,7,7,5,0,0,0,0,17562,7.4,19775,228,59,1249,3078,22.8,1756.2
4517200256,0,18,5,0,7,8,6,0,0,0,0,16423,7.2,18901,212,60,-859,919,21.2,1642.3,17,3,1,8,7,6,0,0,0,0,17282,7.0,17982,226,43,859,-919,22.6,1728.2
4469526700,1,106,0,1,12,4,12,1,1,0,0,19058,7.2,19477,214,61,3723,2815,21.4,1905.8,11,1,0,4,12,7,1,0,1,0,15335,6.6,16662,200,48,-3723,-2815,20.0,1533.5
4524537915,0,15,2,0,10,5,8,1,1,0,0,18497,7.2,19069,223,54,3609,3620,22.3,1849.7,13,2,1,5,10,5,0,0,0,0,14888,6.4,15449,174,52,-3609,-3620,17.4,1488.8
4518436678,0,15,2,0,2,7,2,0,0,0,0,15114,6.8,17597,219,64,-1158,-1281,21.9,1511.4,15,3,1,7,2,6,2,1,1,0,16272,7.2,18878,231,44,1158,1281,23.1,1627.2
4519341811,1,42,1,1,12,5,10,0,0,0,0,19270,7.6,19668,229,55,3855,1646,22.9,1927.0,13,0,0,5,12,1,2,1,1,0,15415,7.0,18022,213,56,-3855,-1646,21.3,1541.5
4506573625,0,221,1,0,2,14,1,0,0,0,0,13121,6.0,14672,172,32,-6707,-5252,17.2,1312.1,31,1,1,14,2,13,2,1,1,0,19828,7.6,19924,203,55,6707,5252,20.3,1982.8
4512974012,0,14,3,0,0,6,0,0,0,0,0,14197,6.8,17915,255,54,-2313,-1210,25.5,1419.7,60,3,1,6,0,6,0,0,0,0,16510,7.2,19125,231,64,2313,1210,23.1,1651.0
4510890954,0,40,3,1,8,8,6,1,1,0,0,16707,6.6,17154,217,44,-164,343,21.7,1670.7,13,13,0,8,8,12,0,0,0,0,16871,6.8,16811,174,49,164,-343,17.4,1687.1
4440191249,1,15,1,1,10,7,8,0,0,0,0,18126,7.2,18581,222,40,2361,2502,22.2,1812.6,10,1,0,7,10,4,1,1,0,0,15765,6.2,16079,176,40,-2361,-2502,17.6,1576.5
4489369709,0,17,4,1,7,6,6,0,0,0,0,16457,7.0,18265,202,56,265,-267,20.2,1645.7,16,4,0,6,7,4,1,1,0,0,16192,7.0,18532,234,63,-265,267,23.4,1619.2
4516576822,0,18,2,0,5,5,5,0,0,0,0,15364,6.8,17090,198,48,-799,-588,19.8,1536.4,14,3,1,5,5,6,0,0,0,0,16163,6.8,17678,242,44,799,588,24.2,1616.3
4523653027,1,19,3,1,5,4,7,0,0,0,0,16989,7.0,18031,256,60,2000,1065,25.6,1698.9,16,4,0,4,5,7,1,1,0,0,14989,6.8,16966,206,51,-2000,-1065,20.6,1498.9
4511011052,1,37,4,0,19,3,25,0,0,0,1,23278,7.8,22125,240,48,8667,7645,24.0,2327.8,15,3,1,3,19,7,0,0,0,0,14611,6.2,14480,189,46,-8667,-7645,18.9,1461.1
4476455937,0,15,5,0,6,10,7,0,0,0,0,15530,7.0,18389,222,40,-1932,-930,22.2,1553.0,17,6,1,10,6,6,1,1,0,0,17462,7.4,19319,232,39,1932,930,23.2,1746.2
4508492240,0,18,5,1,8,3,9,1,1,0,0,17073,6.8,16988,195,60,2939,993,19.5,1707.3,15,3,0,3,8,3,0,0,0,0,14134,6.6,15995,197,44,-2939,-993,19.7,1413.4
4509748129,0,17,4,0,2,5,1,1,1,0,0,14653,6.6,16215,218,52,-1387,-1802,21.8,1465.3,53,5,1,5,2,8,1,0,1,0,16040,6.8,18017,188,61,1387,1802,18.8,1604.0
4522839923,1,15,4,1,3,5,6,1,1,0,0,16120,7.0,18058,246,53,-576,-1269,24.6,1612.0,88,1,0,5,3,6,1,0,1,0,16696,7.2,19327,228,59,576,1269,22.8,1669.6
4507890297,1,17,3,1,6,3,8,1,0,1,0,16481,7.0,18642,229,47,760,45,22.9,1648.1,18,0,0,3,6,3,1,1,0,0,15721,7.0,18597,232,65,-760,-45,23.2,1572.1
4524792382,0,41,1,1,7,8,8,1,1,0,0,15956,6.6,17062,200,44,-916,-1466,20.0,1595.6,12,1,0,8,7,6,0,0,0,0,16872,7.2,18528,204,52,916,1466,20.4,1687.2
4494986980,0,14,3,0,0,9,0,0,0,0,0,13345,6.6,15982,230,42,-5508,-3648,23.0,1334.5,38,3,1,9,0,10,1,1,0,1,18853,7.2,19630,235,57,5508,3648,23.5,1885.3
4473438026,1,17,4,1,8,4,11,1,1,0,0,17117,7.0,18326,204,52,1810,1012,20.4,1711.7,19,4,0,4,8,6,0,0,0,0,15307,6.6,17314,211,44,-1810,-1012,21.1,1530.7
4464386796,0,14,1,0,5,10,2,1,0,1,0,15974,6.8,18618,226,60,-2545,-1541,22.6,1597.4,13,4,1,10,5,9,1,1,0,0,18519,7.6,20159,247,56,2545,1541,24.7,1851.9
4502673310,0,28,2,0,3,7,3,0,0,0,0,14525,6.6,16786,201,56,-5011,-2444,20.1,1452.5,22,1,1,7,3,5,0,0,0,1,19536,7.2,19230,244,52,5011,2444,24.4,1953.6
4525072812,0,14,2,0,7,7,10,1,1,0,0,16972,7.2,19060,209,48,-1031,-394,20.9,1697.2,16,4,1,7,7,7,0,0,0,0,18003,7.4,19454,255,60,1031,394,25.5,1800.3
4526921944,1,16,5,0,7,6,9,1,1,0,0,17108,7.0,18548,230,59,990,1798,23.0,1710.8,51,6,1,6,7,6,0,0,0,0,16118,6.6,16750,218,48,-990,-1798,21.8,1611.8
4525539438,0,17,2,0,5,11,3,0,0,0,0,15645,6.8,16821,203,42,-2328,-1524,20.3,1564.5,18,3,1,11,5,13,1,1,0,0,17973,6.8,18345,209,40,2328,1524,20.9,1797.3
4491104040,0,12,5,0,6,6,8,1,1,0,0,16744,6.8,18061,231,59,-615,-150,23.1,1674.4,22,2,1,6,6,7,0,0,0,0,17359,7.0,18211,237,48,615,150,23.7,1735.9
4521560352,0,16,1,0,1,8,2,0,0,0,0,13880,6.2,15178,191,54,-3063,-2326,19.1,1388.0,47,1,1,8,1,9,1,1,0,0,16943,6.8,17504,187,40,3063,2326,18.7,1694.3
4520816050,1,16,7,1,9,3,8,2,1,1,0,17577,7.4,20010,210,64,2812,2747,21.0,1757.7,16,3,0,3,9,4,0,0,0,0,14765,6.8,17263,205,56,-2812,-2747,20.5,1476.5
4518610443,0,18,4,0,6,7,9,1,1,0,0,15689,6.6,17178,171,63,-808,-266,17.1,1568.9,13,3,1,7,6,9,0,0,0,0,16497,6.8,17444,211,52,808,266,21.1,1649.7
4515437338,1,16,5,1,9,3,10,2,1,1,0,18293,7.2,19981,240,59,3691,2805,24.0,1829.3,11,3,0,3,9,3,0,0,0,0,14602,7.0,17176,186,51,-3691,-2805,18.6,1460.2
4467567796,0,18,1,1,9,8,10,2,1,1,0,17431,6.8,18061,178,60,253,-121,17.8,1743.1,13,2,0,8,9,6,0,0,0,0,17178,7.0,18182,224,56,-253,121,22.4,1717.8
4465123889,1,16,3,0,8,11,11,0,0,0,0,17554,6.6,16706,227,43,-1548,-1988,22.7,1755.4,20,7,1,11,8,13,2,1,1,0,19102,7.0,18694,225,58,1548,1988,22.5,1910.2
4450477657,1,13,2,1,8,6,5,0,0,0,1,17952,7.0,18161,210,32,2123,2563,21.0,1795.2,15,3,0,6,8,8,1,1,0,0,15829,6.2,15598,192,32,-2123,-2563,19.2,1582.9
4523731110,1,36,4,1,11,3,14,1,1,0,0,19276,7.4,19210,237,42,4275,2943,23.7,1927.6,16,1,0,3,11,6,0,0,0,0,15001,6.4,16267,205,43,-4275,-2943,20.5,1500.1
4478467708,1,19,3,1,4,3,2,1,1,0,0,16029,7.4,19239,236,71,771,1255,23.6,1602.9,13,5,0,3,4,3,1,0,1,0,15258,7.0,17984,208,64,-771,-1255,20.8,1525.8
4515532917,0,15,6,1,3,5,5,0,0,0,0,14378,6.4,16230,209,39,-3682,-3599,20.9,1437.8,14,3,0,5,3,2,2,1,1,1,18060,7.4,19829,245,66,3682,3599,24.5,1806.0
4521862362,1,15,4,0,9,11,4,0,0,0,0,17525,7.0,16972,202,48,-437,-1284,20.2,1752.5,29,3,1,11,9,12,1,1,0,0,17962,6.8,18256,190,44,437,1284,19.0,1796.2
4519091334,0,37,1,1,4,7,4,1,1,0,0,14867,7.0,17173,216,35,-2153,-2348,21.6,1486.7,15,2,0,7,4,4,0,0,0,0,17020,7.2,19521,220,75,2153,2348,22.0,1702.0
4518324139,0,21,3,0,2,3,2,1,1,0,0,14746,7.0,17859,237,56,-1222,-815,23.7,1474.6,18,2,1,3,2,2,0,0,0,0,15968,7.2,18674,246,44,1222,815,24.6,1596.8
4524841427,0,16,2,1,9,8,12,1,0,1,0,16649,6.2,15616,166,36,-1152,-2193,16.6,1664.9,19,2,0,8,9,8,1,1,0,0,17801,6.8,17809,208,48,1152,2193,20.8,1780.1
4456493473,0,13,3,0,1,3,0,0,0,0,0,13751,6.8,17182,199,60,-2507,-1567,19.9,1375.1,18,4,1,3,1,3,1,1,0,0,16258,7.2,18749,269,48,2507,1567,26.9,1625.8
4475624024,1,71,5,0,6,4,6,0,0,0,0,16112,6.8,17631,207,42,922,146,20.7,1611.2,23,4,1,4,6,5,2,1,1,0,15190,7.0,17485,199,72,-922,-146,19.9,1519.0
4477722271,1,35,1,0,4,4,5,0,0,0,0,16349,7.2,18699,253,62,754,13,25.3,1634.9,13,3,1,4,4,3,1,1,0,0,15595,7.2,18686,243,55,-754,-13,24.3,1559.5
4514848856,0,16,1,0,8,3,7,1,1,0,0,16786,7.0,18389,250,32,651,2427,25.0,1678.6,18,2,1,3,8,3,1,0,1,1,16135,6.4,15962,201,69,-651,-2427,20.1,1613.5
4500342902,0,17,2,0,7,7,10,1,1,0,0,16728,7.0,17494,231,36,102,65,23.1,1672.8,24,5,1,7,7,8,0,0,0,0,16626,6.6,17429,195,52,-102,-65,19.5,1662.6
4521934653,1,15,1,1,9,7,12,0,0,0,0,17704,7.0,18183,196,68,639,1171,19.6,1770.4,15,1,0,7,9,10,0,0,0,0,17065,6.4,17012,208,39,-639,-1171,20.8,1706.5
4474818952,1,14,1,0,9,3,12,2,1,1,0,18108,7.0,18738,218,45,2967,947,21.8,1810.8,12,4,1,3,9,1,0,0,0,0,15141,6.8,17791,228,76,-2967,-947,22.8,1514.1
4500388564,1,16,4,1,5,8,5,1,0,1,0,16607,7.0,17949,223,68,-1001,-543,22.3,1660.7,54,2,0,8,5,10,1,1,0,0,17608,7.0,18492,229,41,1001,543,22.9,1760.8
4506389635,1,15,3,1,6,7,5,0,0,0,0,16940,7.2,17909,246,38,566,-57,24.6,1694.0,16,4,0,7,6,11,0,0,0,0,16374,7.2,17966,219,37,-566,57,21.9,1637.4
4521865491,1,11,2,1,14,6,15,0,0,0,0,21087,7.6,20108,215,36,5260,2633,21.5,2108.7,39,1,0,6,14,5,1,1,0,0,15827,7.0,17475,193,48,-5260,-2633,19.3,1582.7
4523763219,1,17,3,1,7,2,9,1,0,1,0,17557,7.0,18193,209,64,3822,2980,20.9,1755.7,18,2,0,2,7,1,0,0,0,0,13735,6.0,15213,224,24,-3822,-2980,22.4,1373.5
4450484115,1,17,3,1,11,3,9,1,1,0,0,18583,7.2,18852,204,55,4280,2681,20.4,1858.3,17,1,0,3,11,2,0,0,0,0,14303,6.4,16171,202,48,-4280,-2681,20.2,1430.3
4496160453,0,14,2,0,6,7,5,0,0,0,0,16169,6.6,17326,214,42,-620,-1984,21.4,1616.9,18,5,1,7,6,4,2,1,1,0,16789,7.0,19310,237,56,620,1984,23.7,1678.9
4497751825,0,17,3,1,7,10,5,0,0,0,0,15351,6.0,13858,169,52,-2827,-2675,16.9,1535.1,17,5,0,10,7,11,1,1,0,0,18178,6.4,16533,181,52,2827,2675,18.1,1817.8
4472951560,1,21,4,0,13,8,16,1,1,0,0,19865,7.2,18655,225,39,2819,1294,22.5,1986.5,14,4,1,8,13,8,0,0,0,0,17046,6.8,17361,210,44,-2819,-1294,21.0,1704.6
4493140120,1,17,7,1,4,2,2,0,0,0,0,16452,7.2,19307,273,60,1068,618,27.3,1645.2,16,4,0,2,4,4,0,0,0,0,15384,7.2,18689,253,68,-1068,-618,25.3,1538.4
4524932837,1,17,3,1,9,1,9,1,1,0,0,17079,7.0,17962,229,44,3916,2599,22.9,1707.9,16,0,0,1,9,0,0,0,0,0,13163,6.6,15363,191,44,-3916,-2599,19.1,1316.3
4509940974,0,19,5,1,6,10,7,0,0,0,0,15787,6.8,16711,205,37,-2457,-1625,20.5,1578.7,22,6,0,10,6,10,1,0,1,0,18244,7.0,18336,238,53,2457,1625,23.8,1824.4
4524779712,1,17,0,1,7,5,11,1,0,1,0,16977,7.0,17852,201,44,1753,847,20.1,1697.7,9,5,0,5,7,9,1,1,0,0,15224,6.6,17005,186,49,-1753,-847,18.6,1522.4
4520057356,0,16,3,0,3,6,2,0,0,0,0,15731,6.6,17150,251,42,-1057,-1798,25.1,1573.1,20,1,1,6,3,9,1,1,0,0,16788,7.2,18948,220,64,1057,1798,22.0,1678.8
4441631647,0,17,4,1,3,7,3,1,1,0,0,14900,7.0,18354,214,60,-1966,263,21.4,1490.0,19,5,0,7,3,7,0,0,0,0,16866,7.2,18091,214,54,1966,-263,21.4,1686.6
4519595865,0,16,5,0,3,8,4,1,0,1,0,14506,6.8,16989,206,52,-2520,-1932,20.6,1450.6,16,1,1,8,3,7,1,1,0,0,17026,7.2,18921,221,56,2520,1932,22.1,1702.6
4511340293,1,14,3,1,10,2,15,1,1,0,0,18142,7.2,18432,224,53,3680,2530,22.4,1814.2,15,2,0,2,10,1,0,0,0,0,14462,6.6,15902,190,53,-3680,-2530,19.0,1446.2
4468926711,1,15,1,0,4,8,4,0,0,0,0,15337,6.6,16778,217,40,-2811,-2298,21.7,1533.7,17,2,1,8,4,7,1,1,0,0,18148,7.2,19076,224,56,2811,2298,22.4,1814.8
4523529962,1,17,24,1,11,6,15,1,1,0,0,18205,7.0,18119,207,38,2002,1791,20.7,1820.5,40,4,0,6,11,9,0,0,0,0,16203,6.4,16328,208,36,-2002,-1791,20.8,1620.3
4478004780,0,33,5,1,4,4,5,1,1,0,0,15716,6.8,17691,235,53,-1555,-1025,23.5,1571.6,18,2,0,4,4,4,1,0,1,1,17271,7.0,18716,237,54,1555,1025,23.7,1727.1
4481320434,1,22,3,1,9,1,12,0,0,0,0,18681,7.4,20293,249,59,5492,4505,24.9,1868.1,12,0,0,1,9,1,1,0,1,0,13189,6.4,15788,181,48,-5492,-4505,18.1,1318.9
4419611773,1,18,2,1,10,11,13,0,0,0,0,17447,6.4,16191,173,38,-384,-1658,17.3,1744.7,12,1,0,11,10,9,0,0,0,0,17831,7.0,17849,208,40,384,1658,20.8,1783.1
4521814295,0,14,6,0,7,4,7,1,0,1,0,16806,6.8,17149,217,50,1904,892,21.7,1680.6,38,6,1,4,7,4,0,0,0,0,14902,6.4,16257,200,55,-1904,-892,20.0,1490.2
4487705166,1,59,2,0,3,6,6,1,1,0,0,15442,6.8,17518,238,51,-1090,-1499,23.8,1544.2,11,17,1,6,3,6,0,0,0,0,16532,6.8,19017,233,56,1090,1499,23.3,1653.2
4495602033,0,18,1,0,7,8,8,0,0,0,0,17472,6.8,18276,229,52,-214,-356,22.9,1747.2,13,3,1,8,7,9,2,1,1,0,17686,7.0,18632,211,52,214,356,21.1,1768.6
4500216445,1,18,2,1,8,7,10,0,0,0,0,17450,7.2,18989,236,52,270,638,23.6,1745.0,17,4,0,7,8,5,1,0,1,0,17180,6.8,18351,220,48,-270,-638,22.0,1718.0
4522849346,0,86,3,1,6,3,6,1,0,1,0,17395,7.2,18998,252,56,2234,1606,25.2,1739.5,22,2,0,3,6,5,1,1,0,0,15161,7.0,17392,226,56,-2234,-1606,22.6,1516.1
4519995734,0,20,6,0,8,6,10,1,0,1,1,18909,7.2,18843,237,40,3023,2115,23.7,1890.9,18,3,1,6,8,7,1,1,0,0,15886,6.6,16728,211,44,-3023,-2115,21.1,1588.6
4494055420,1,15,5,0,8,7,8,1,0,1,0,16463,6.4,16544,186,40,-460,-1189,18.6,1646.3,18,3,1,7,8,4,0,0,0,0,16923,6.8,17733,238,48,460,1189,23.8,1692.3
4460653436,0,40,1,0,5,11,8,0,0,0,0,16177,7.0,18425,224,45,-1546,-710,22.4,1617.7,15,6,1,11,5,12,1,1,0,0,17723,7.4,19135,183,58,1546,710,18.3,1772.3
4519728493,1,18,2,1,10,4,13,1,0,1,0,17902,7.2,18882,186,50,2224,2062,18.6,1790.2,15,2,0,4,10,7,1,1,0,0,15678,6.6,16820,208,44,-2224,-2062,20.8,1567.8
4458264663,0,16,2,0,3,9,4,0,0,0,0,14471,7.0,17643,208,40,-3385,-2781,20.8,1447.1,16,7,1,9,3,8,1,1,0,0,17856,7.4,20424,223,44,3385,2781,22.3,1785.6
4438792518,1,17,2,1,5,2,5,1,1,0,0,16326,7.0,18135,217,60,1697,293,21.7,1632.6,11,1,0,2,5,2,1,0,1,0,14629,6.6,17842,246,40,-1697,-293,24.6,1462.9
4475523215,0,13,0,0,6,12,6,0,0,0,0,15951,6.6,16512,223,40,-1734,-3696,22.3,1595.1,16,3,1,12,6,5,2,1,1,0,17685,7.6,20208,221,44,1734,3696,22.1,1768.5
4510569686,0,19,3,0,8,10,9,0,0,0,0,17139,6.6,16389,199,50,-201,-1063,19.9,1713.9,55,2,1,10,8,11,1,1,0,0,17340,6.8,17452,167,41,201,1063,16.7,1734.0
4518241123,0,14,0,0,4,11,4,0,0,0,0,12178,4.6,10098,120,20,-6754,-5726,12.0,1217.8,15,2,1,11,4,14,0,0,0,1,18932,6.4,15824,203,36,6754,5726,20.3,1893.2
4483094981,1,16,3,0,6,4,8,1,1,0,0,17505,7.2,18661,240,66,791,1138,24.0,1750.5,16,2,1,4,6,5,0,0,0,0,16714,6.6,17523,234,49,-791,-1138,23.4,1671.4
4523728441,1,7,0,1,9,11,10,1,1,0,0,18601,7.0,18627,220,63,1939,166,22.0,1860.1,13,1,0,11,9,7,0,0,0,0,16662,7.0,18461,174,44,-1939,-166,17.4,1666.2
4519443312,0,16,3,0,6,11,8,1,1,0,0,15930,6.8,17257,200,43,-3549,-2407,20.0,1593.0,14,4,1,11,6,12,0,0,0,0,19479,7.4,19664,214,60,3549,2407,21.4,1947.9
4525841873,0,16,4,1,10,3,9,1,1,0,0,17631,6.8,18612,201,44,3436,1760,20.1,1763.1,13,4,0,3,10,1,1,0,1,0,14195,6.6,16852,206,48,-3436,-1760,20.6,1419.5
4464122036,1,13,9,1,7,3,7,1,0,1,0,16934,7.0,19205,228,44,1714,1369,22.8,1693.4,44,2,0,3,7,4,1,1,0,0,15220,6.8,17836,229,51,-1714,-1369,22.9,1522.0
4465134989,1,22,7,1,6,3,5,1,1,0,0,16942,7.0,18645,216,71,2032,2196,21.6,1694.2,85,4,0,3,6,3,0,0,0,0,14910,6.4,16449,210,48,-2032,-2196,21.0,1491.0
4488789257,0,18,2,1,5,7,8,0,0,0,0,15885,6.6,16848,220,43,-1566,-2539,22.0,1588.5,17,5,0,7,5,7,1,1,0,0,17451,7.2,19387,221,80,1566,2539,22.1,1745.1
4519438725,1,10,1,1,5,6,9,1,1,0,0,15822,7.0,17481,219,48,-1572,-2164,21.9,1582.2,24,1,0,6,5,3,1,0,1,0,17394,7.2,19645,248,56,1572,2164,24.8,1739.4
4509719745,1,44,6,0,13,6,13,0,0,0,0,18933,7.4,19905,210,45,2109,3154,21.0,1893.3,19,2,1,6,13,10,0,0,0,0,16824,6.6,16751,194,50,-2109,-3154,19.4,1682.4
4462358723,0,15,4,1,5,7,2,0,0,0,0,15210,6.4,15974,172,40,-1656,-1832,17.2,1521.0,13,5,0,7,5,3,0,0,0,0,16866,6.8,17806,219,51,1656,1832,21.9,1686.6
4502376872,0,18,1,0,5,9,6,0,0,0,0,14988,6.6,16513,200,40,-2824,-2021,20.0,1498.8,16,4,1,9,5,10,0,0,0,0,17812,6.8,18534,222,56,2824,2021,22.2,1781.2
4458921343,0,15,0,0,9,2,9,1,0,1,0,17781,7.2,19251,228,60,3422,2271,22.8,1778.1,11,3,1,2,9,3,1,1,0,0,14359,6.6,16980,212,64,-3422,-2271,21.2,1435.9
4456677220,0,15,1,0,2,10,2,0,0,0,0,14194,6.2,14858,195,48,-5553,-4226,19.5,1419.4,13,0,1,10,2,12,1,0,1,1,19747,7.2,19084,233,49,5553,4226,23.3,1974.7
4505220147,0,17,3,0,4,11,7,0,0,0,0,15224,6.8,16862,189,43,-3595,-1973,18.9,1522.4,19,4,1,11,4,11,1,1,0,0,18819,7.0,18835,221,68,3595,1973,22.1,1881.9
4472245505,0,13,1,0,6,7,12,1,1,0,0,16942,7.2,17991,247,43,330,-308,24.7,1694.2,19,4,1,7,6,6,1,0,1,0,16612,7.0,18299,192,59,-330,308,19.2,1661.2
4494830005,0,22,5,0,2,2,1,1,1,0,0,14569,6.6,16559,227,38,-676,-864,22.7,1456.9,13,12,1,2,2,3,0,0,0,0,15245,6.8,17423,236,46,676,864,23.6,1524.5
4517750009,1,12,2,1,6,7,9,1,1,0,0,16815,7.2,17824,235,48,683,-208,23.5,1681.5,15,0,0,7,6,12,1,0,1,0,16132,6.8,18032,179,48,-683,208,17.9,1613.2
4467214068,0,90,8,0,2,10,2,1,0,1,0,14519,6.8,17122,223,40,-3798,-2950,22.3,1451.9,45,5,1,10,2,13,1,1,0,0,18317,7.4,20072,226,64,3798,2950,22.6,1831.7
4450445125,0,13,3,0,0,5,0,1,0,1,0,14103,6.6,17162,230,66,-1977,-700,23.0,1410.3,13,3,1,5,0,4,0,0,0,0,16080,7.0,17862,224,54,1977,700,22.4,1608.0
4459784621,0,11,1,0,5,9,4,0,0,0,0,15102,6.8,18032,174,68,-5691,-2006,17.4,1510.2,14,2,1,9,5,8,2,1,1,2,20793,7.4,20038,226,56,5691,2006,22.6,2079.3
4507366175,1,17,1,1,4,4,3,1,1,0,0,15239,7.2,18213,222,49,-251,231,22.2,1523.9,15,3,0,4,4,6,1,0,1,0,15490,6.8,17982,213,55,251,-231,21.3,1549.0
4464852917,1,18,1,0,7,11,10,0,0,0,0,16943,6.8,17177,215,52,-1228,-1785,21.5,1694.3,41,4,1,11,7,11,1,1,0,0,18171,7.4,18962,217,56,1228,1785,21.7,1817.1
4522467340,1,19,5,0,6,5,5,0,0,0,0,16391,6.8,17693,222,44,709,946,22.2,1639.1,41,2,1,5,6,6,0,0,0,0,15682,6.8,16747,188,59,-709,-946,18.8,1568.2
4519857386,1,17,4,1,5,4,4,0,0,0,0,17431,7.2,18675,272,46,300,427,27.2,1743.1,17,2,0,4,5,3,2,1,1,1,17131,7.0,18248,236,56,-300,-427,23.6,1713.1
4487544750,1,26,5,0,8,5,8,1,1,0,0,17346,7.0,18654,208,52,1482,1629,20.8,1734.6,19,0,1,5,8,6,0,0,0,0,15864,6.8,17025,211,47,-1482,-1629,21.1,1586.4
4464174645,0,17,2,0,8,10,2,0,0,0,0,16163,6.8,16956,201,32,-1825,-1174,20.1,1616.3,19,2,1,10,8,13,1,1,0,0,17988,7.2,18130,196,40,1825,1174,19.6,1798.8
4498316696,0,53,4,0,5,10,4,0,0,0,0,15649,7.0,17686,199,52,-2870,-2023,19.9,1564.9,15,0,1,10,5,14,1,1,0,0,18519,7.2,19709,229,60,2870,2023,22.9,1851.9
4462298411,1,21,6,1,6,2,7,1,0,1,0,16836,7.2,19773,242,60,2569,2378,24.2,1683.6,41,4,0,2,6,1,1,1,0,0,14267,6.8,17395,228,45,-2569,-2378,22.8,1426.7
4462505118,0,16,2,0,8,9,9,0,0,0,0,16075,6.8,17316,200,45,-1778,-1128,20.0,1607.5,19,5,1,9,8,10,1,1,0,0,17853,7.0,18444,208,50,1778,1128,20.8,1785.3
4459961867,0,15,4,1,8,6,11,1,0,1,0,17662,7.2,19112,219,60,1016,310,21.9,1766.2,20,3,0,6,8,8,1,1,0,0,16646,7.2,18802,231,60,-1016,-310,23.1,1664.6
4506216514,1,57,2,1,4,2,5,1,1,0,0,16647,7.4,20048,240,84,2179,2663,24.0,1664.7,39,2,0,2,4,1,0,0,0,0,14468,6.8,17385,226,44,-2179,-2663,22.6,1446.8
4521052403,1,15,1,1,8,3,6,0,0,0,0,17263,7.2,19913,234,65,3181,3298,23.4,1726.3,11,2,0,3,8,3,2,1,1,0,14082,6.8,16615,159,51,-3181,-3298,15.9,1408.2
4517196528,1,13,0,0,6,4,4,0,0,0,0,17649,7.4,19655,276,50,2194,2684,27.6,1764.9,14,0,1,4,6,3,1,1,0,0,15455,6.8,16971,221,58,-2194,-2684,22.1,1545.5
4524783374,1,33,2,0,14,10,9,0,0,0,0,18595,7.0,18307,199,48,1543,-21,19.9,1859.5,37,3,1,10,14,8,1,1,0,0,17052,7.0,18328,172,52,-1543,21,17.2,1705.2
4456161907,0,146,3,1,2,4,1,0,0,0,0,14848,6.8,17467,205,65,-132,119,20.5,1484.8,15,2,0,4,2,3,1,1,0,0,14980,6.8,17348,213,44,132,-119,21.3,1498.0
4485856450,0,21,3,0,8,8,10,0,0,0,0,17544,7.2,18246,213,53,-375,-547,21.3,1754.4,20,5,1,8,8,9,1,1,0,0,17919,7.0,18793,230,62,375,547,23.0,1791.9
4477432389,0,33,2,0,6,10,7,0,0,0,0,15820,7.0,18253,203,49,-2116,-1407,20.3,1582.0,14,3,1,10,6,11,1,1,0,0,17936,7.2,19660,223,44,2116,1407,22.3,1793.6
4465014054,0,25,3,1,3,3,3,0,0,0,0,15365,6.8,17502,250,49,-528,-1130,25.0,1536.5,19,6,0,3,3,4,1,1,0,0,15893,7.0,18632,259,55,528,1130,25.9,1589.3
4511927788,0,26,2,0,2,7,1,0,0,0,0,14918,6.8,17605,221,53,-2442,-1427,22.1,1491.8,17,2,1,7,2,10,1,1,0,0,17360,7.2,19032,262,48,2442,1427,26.2,1736.0
4512831945,1,15,2,1,10,2,11,0,0,0,0,19151,7.4,19146,220,52,5241,3129,22.0,1915.1,15,2,0,2,10,3,2,1,1,0,13910,6.4,16017,196,51,-5241,-3129,19.6,1391.0
4519379201,1,53,2,0,7,17,5,0,0,0,0,15664,6.6,16740,174,48,-4732,-1805,17.4,1566.4,16,4,1,17,7,20,1,1,0,0,20396,7.0,18545,228,38,4732,1805,22.8,2039.6
4522521033,0,16,3,1,8,13,6,0,0,0,0,17705,6.8,17690,201,44,-1291,-1067,20.1,1770.5,18,4,0,13,8,16,0,0,0,0,18996,7.2,18757,213,31,1291,1067,21.3,1899.6
4524068171,0,18,3,1,9,6,8,0,0,0,0,16961,6.6,17237,191,48,531,-881,19.1,1696.1,17,2,0,6,9,13,1,1,0,0,16430,7.2,18118,198,60,-531,881,19.8,1643.0
4522209183,1,13,0,0,12,8,12,0,0,0,0,18968,7.0,18902,201,36,1686,886,20.1,1896.8,17,1,1,8,12,8,0,0,0,0,17282,7.0,18016,186,64,-1686,-886,18.6,1728.2
4513103851,0,17,2,1,7,7,8,1,1,0,0,17191,6.8,17267,206,48,-347,-2753,20.6,1719.1,14,1,0,7,7,11,0,0,0,0,17538,7.6,20020,212,68,347,2753,21.2,1753.8
4516779664,1,16,1,0,7,2,10,0,0,0,0,17198,7.4,19868,233,62,1926,2119,23.3,1719.8,51,1,1,2,7,2,0,0,0,0,15272,6.8,17749,219,73,-1926,-2119,21.9,1527.2
4507083643,1,15,1,1,11,8,15,2,1,1,0,17640,6.6,17082,164,45,1252,-271,16.4,1764.0,14,3,0,8,11,11,0,0,0,0,16388,6.8,17353,176,52,-1252,271,17.6,1638.8
4497864725,1,20,7,1,11,2,16,0,0,0,0,19770,7.2,19116,232,48,5120,3137,23.2,1977.0,16,3,0,2,11,2,2,1,1,0,14650,6.4,15979,191,64,-5120,-3137,19.1,1465.0
4514051378,1,12,4,0,11,9,11,1,1,0,0,17774,7.0,18440,180,49,-76,1386,18.0,1777.4,19,0,1,9,11,9,0,0,0,0,17850,6.8,17054,190,60,76,-1386,19.0,1785.0
4475087620,1,17,4,1,6,6,6,1,1,0,0,16004,7.0,18381,216,38,-695,-683,21.6,1600.4,14,4,0,6,6,6,0,0,0,0,16699,7.0,19064,240,52,695,683,24.0,1669.9
4505122795,0,14,3,0,1,5,1,0,0,0,0,14001,6.4,16037,221,52,-2744,-1330,22.1,1400.1,20,3,1,5,1,11,1,1,0,0,16745,7.0,17367,244,44,2744,1330,24.4,1674.5
4469763796,1,14,1,1,11,3,14,1,1,0,1,19278,7.4,19529,226,42,4230,3209,22.6,1927.8,14,2,0,3,11,3,0,0,0,0,15048,6.4,16320,186,66,-4230,-3209,18.6,1504.8
4521091786,0,15,0,1,6,9,5,1,0,1,0,16525,6.8,18095,204,47,-1782,-972,20.4,1652.5,18,3,0,9,6,11,1,1,0,0,18307,7.2,19067,217,67,1782,972,21.7,1830.7
4477722097,0,13,2,1,3,1,4,1,0,1,0,16156,7.0,18605,233,61,1639,1308,23.3,1615.6,14,4,0,1,3,3,1,1,0,0,14517,7.0,17297,241,40,-1639,-1308,24.1,1451.7
4472723293,0,15,2,0,7,5,11,0,0,0,0,16230,6.6,16813,181,52,-30,-965,18.1,1623.0,13,3,1,5,7,5,0,0,0,0,16260,6.8,17778,231,51,30,965,23.1,1626.0
4451694219,0,24,0,0,1,5,0,0,0,0,0,14824,7.2,18421,230,72,-1424,-2416,23.0,1482.4,14,2,1,5,1,3,1,1,0,0,16248,7.6,20837,228,68,1424,2416,22.8,1624.8
4455725708,1,13,2,1,12,10,10,1,1,0,0,18913,7.2,19076,183,55,1051,12,18.3,1891.3,13,0,0,10,12,7,0,0,0,0,17862,7.2,19064,209,40,-1051,-12,20.9,1786.2
4513037012,1,17,5,1,11,7,6,2,1,1,0,18413,7.2,19681,228,60,2377,2335,22.8,1841.3,22,2,0,7,11,7,0,0,0,0,16036,7.0,17346,172,60,-2377,-2335,17.2,1603.6
4469904395,1,16,0,0,4,7,5,1,1,0,0,15524,7.0,17843,228,56,-629,-209,22.8,1552.4,24,1,1,7,4,7,0,0,0,0,16153,6.8,18052,192,55,629,209,19.2,1615.3
4484601181,1,16,0,0,8,5,8,2,1,1,0,17390,7.2,19016,212,60,1716,1837,21.2,1739.0,15,1,1,5,8,8,0,0,0,0,15674,6.8,17179,226,36,-1716,-1837,22.6,1567.4
4511067613,0,15,6,0,8,7,9,1,1,0,0,17163,7.2,18565,221,60,515,1691,22.1,1716.3,15,1,1,7,8,14,0,0,0,0,16648,6.6,16874,211,43,-515,-1691,21.1,1664.8
4464132605,1,15,2,0,4,3,2,2,1,1,0,15517,6.8,17441,215,52,697,951,21.5,1551.7,12,3,1,3,4,3,0,0,0,0,14820,6.8,16490,211,48,-697,-951,21.1,1482.0
4472130589,1,15,5,0,4,7,2,1,1,0,0,15682,6.8,17438,234,60,-1075,73,23.4,1568.2,19,2,1,7,4,6,0,0,0,0,16757,6.8,17365,213,51,1075,-73,21.3,1675.7
4438188395,0,19,3,0,9,8,8,0,0,0,0,16823,6.8,17411,219,33,-1071,-1667,21.9,1682.3,18,2,1,8,9,10,1,1,0,0,17894,7.2,19078,210,63,1071,1667,21.0,1789.4
4512263036,1,21,17,1,11,6,14,2,1,1,0,18894,6.8,17315,201,51,3536,1244,20.1,1889.4,46,5,0,6,11,5,0,0,0,0,15358,6.6,16071,187,36,-3536,-1244,18.7,1535.8
4509965953,0,15,4,0,2,11,1,0,0,0,0,14316,6.6,16505,214,48,-4885,-2721,21.4,1431.6,18,2,1,11,2,12,2,1,1,0,19201,7.4,19226,249,55,4885,2721,24.9,1920.1
4510534597,0,15,3,0,3,9,3,0,0,0,0,14512,6.6,16088,226,32,-3476,-4019,22.6,1451.2,13,0,1,9,3,6,2,1,1,0,17988,7.4,20107,249,55,3476,4019,24.9,1798.8
4518980020,0,11,0,0,6,4,3,0,0,0,0,16796,7.4,19792,256,59,311,707,25.6,1679.6,15,3,1,4,6,4,1,1,0,0,16485,7.2,19085,241,66,-311,-707,24.1,1648.5
4521135230,1,16,1,1,8,1,8,1,1,0,0,17613,7.2,19092,234,48,3949,2440,23.4,1761.3,40,3,0,1,8,2,0,0,0,0,13664,6.6,16652,216,44,-3949,-2440,21.6,1366.4
4520626535,1,12,5,0,13,7,13,1,1,0,0,19718,7.6,20453,215,68,3614,3374,21.5,1971.8,18,3,1,7,13,3,1,0,1,0,16104,6.6,17079,192,46,-3614,-3374,19.2,1610.4
4487268052,0,45,5,0,4,3,5,1,1,0,0,15398,7.2,17861,200,54,378,321,20.0,1539.8,55,6,1,3,4,2,1,0,1,0,15020,7.0,17540,227,48,-378,-321,22.7,1502.0
4527413086,1,49,5,0,6,9,10,0,0,0,0,16600,6.8,17594,213,56,-629,-1232,21.3,1660.0,22,5,1,9,6,10,0,0,0,0,17229,7.0,18826,203,33,629,1232,20.3,1722.9
4513586711,0,27,1,1,2,8,3,1,1,0,0,14071,6.4,16382,202,59,-3952,-2015,20.2,1407.1,118,4,0,8,2,8,0,0,0,0,18023,7.0,18397,228,36,3952,2015,22.8,1802.3
4491827833,0,16,0,0,5,10,5,0,0,0,0,16324,6.8,17213,193,59,-943,-708,19.3,1632.4,40,3,1,10,5,13,1,1,0,0,17267,7.0,17921,174,60,943,708,17.4,1726.7
4525247260,1,18,9,1,9,1,13,1,1,0,0,17461,7.2,18412,235,48,3119,896,23.5,1746.1,44,2,0,1,9,1,1,0,1,0,14342,7.0,17516,228,56,-3119,-896,22.8,1434.2
4444096628,0,32,2,0,10,12,9,0,0,0,0,16174,6.6,16725,149,39,-2452,-1634,14.9,1617.4,14,0,1,12,10,8,0,0,0,0,18626,7.0,18359,210,35,2452,1634,21.0,1862.6
4524411421,1,16,0,0,10,10,14,1,1,0,0,18138,7.0,18159,208,55,908,306,20.8,1813.8,15,1,1,10,10,16,0,0,0,0,17230,7.0,17853,210,44,-908,-306,21.0,1723.0
4462777872,0,16,5,0,12,5,9,0,0,0,0,18279,7.4,18909,174,54,1236,149,17.4,1827.9,15,4,1,5,12,3,2,1,1,0,17043,7.0,18760,224,60,-1236,-149,22.4,1704.3
4522207567,1,16,3,1,12,3,11,1,1,0,0,18248,7.4,19855,201,48,3296,3231,20.1,1824.8,12,0,0,3,12,3,0,0,0,0,14952,6.4,16624,201,47,-3296,-3231,20.1,1495.2
4519990070,0,21,3,0,2,10,3,1,0,1,0,14825,6.8,17113,236,51,-3103,-2355,23.6,1482.5,17,5,1,10,2,16,1,1,0,0,17928,7.2,19468,230,52,3103,2355,23.0,1792.8
4525066184,1,56,3,1,11,4,10,1,1,0,0,17131,7.2,18732,215,44,2036,1891,21.5,1713.1,16,2,0,4,11,3,0,0,0,0,15095,6.8,16841,188,56,-2036,-1891,18.8,1509.5
4459886824,1,11,3,1,10,12,11,1,0,1,0,18177,6.8,17640,203,40,-1253,-1627,20.3,1817.7,18,1,0,12,10,15,1,1,0,0,19430,7.2,19267,235,42,1253,1627,23.5,1943.0
4520588877,0,15,2,0,2,10,2,0,0,0,0,14044,6.6,16501,191,56,-6604,-2014,19.1,1404.4,18,3,1,10,2,6,2,1,1,2,20648,7.2,18515,236,48,6604,2014,23.6,2064.8
4520399820,1,15,3,0,8,6,6,0,0,0,0,18188,7.4,20313,252,76,1667,3434,25.2,1818.8,17,4,1,6,8,8,1,1,0,0,16521,6.4,16879,188,51,-1667,-3434,18.8,1652.1
4495147066,0,13,1,0,2,9,2,0,0,0,0,13267,6.2,14831,185,40,-5292,-4922,18.5,1326.7,14,3,1,9,2,12,1,1,0,0,18559,7.2,19753,237,64,5292,4922,23.7,1855.9
4470651076,1,12,3,1,13,4,11,1,1,0,0,19077,7.2,18861,215,63,3669,3030,21.5,1907.7,17,1,0,4,13,5,0,0,0,0,15408,6.4,15831,207,45,-3669,-3030,20.7,1540.8
4523066845,0,40,1,0,8,4,10,0,0,0,0,16411,6.6,17513,176,43,590,1002,17.6,1641.1,16,5,1,4,8,4,0,0,0,0,15821,6.6,16511,208,47,-590,-1002,20.8,1582.1
4513993269,1,19,5,1,8,3,11,1,1,0,1,18524,7.0,18193,241,44,2702,1047,24.1,1852.4,18,3,0,3,8,5,0,0,0,0,15822,6.8,17146,228,54,-2702,-1047,22.8,1582.2
4409386215,0,25,1,1,4,3,4,0,0,0,0,15838,6.8,18368,221,62,-348,-901,22.1,1583.8,17,4,0,3,4,4,1,1,0,0,16186,7.2,19269,261,66,348,901,26.1,1618.6
4526805817,1,14,1,1,10,3,13,1,1,0,1,19716,7.6,20456,219,64,5656,3415,21.9,1971.6,14,0,0,3,10,1,0,0,0,0,14060,6.6,17041,222,50,-5656,-3415,22.2,1406.0
4439464616,0,15,4,1,4,8,3,0,0,0,0,14901,7.0,17696,209,42,-2427,-1462,20.9,1490.1,16,0,0,8,4,7,0,0,0,0,17328,7.2,19158,224,52,2427,1462,22.4,1732.8
4524045722,1,33,2,1,9,4,8,1,0,1,0,18829,7.2,18693,233,52,4141,2833,23.3,1882.9,12,1,0,4,9,3,0,0,0,0,14688,6.6,15860,198,51,-4141,-2833,19.8,1468.8
4519198030,1,17,8,0,8,8,11,0,0,0,0,17178,7.0,18476,216,44,-597,-1198,21.6,1717.8,21,3,1,8,8,6,0,0,0,0,17775,7.4,19674,253,52,597,1198,25.3,1777.5
4514070165,0,12,0,0,10,7,11,0,0,0,1,20278,7.2,19575,236,58,4633,2269,23.6,2027.8,20,1,1,7,10,6,1,1,0,0,15645,6.6,17306,182,45,-4633,-2269,18.2,1564.5
4469829210,1,34,1,1,9,4,10,2,1,1,0,18303,7.2,19140,263,58,2642,366,26.3,1830.3,16,0,0,4,9,2,0,0,0,0,15661,7.0,18774,231,49,-2642,-366,23.1,1566.1
4512338231,1,13,4,1,7,5,5,1,1,0,0,16790,7.6,19460,241,62,651,1744,24.1,1679.0,13,3,0,5,7,10,0,0,0,0,16139,6.8,17716,186,65,-651,-1744,18.6,1613.9
4495106153,0,15,2,1,10,4,11,2,1,1,0,17816,6.8,18684,202,58,1953,1494,20.2,1781.6,16,5,0,4,10,6,0,0,0,0,15863,7.0,17190,224,41,-1953,-1494,22.4,1586.3
4515568453,0,15,1,0,8,10,6,0,0,0,0,15995,6.8,17109,172,57,-3535,-1199,17.2,1599.5,11,0,1,10,8,13,1,1,0,1,19530,7.2,18308,220,44,3535,1199,22.0,1953.0
4523304225,0,15,0,1,7,8,15,1,1,0,0,15381,6.2,14805,167,39,-1611,-1901,16.7,1538.1,13,2,0,8,7,8,0,0,0,0,16992,6.6,16706,201,53,1611,1901,20.1,1699.2
4515231062,0,16,3,0,4,9,4,1,1,0,0,14588,6.2,15647,207,45,-2627,-4080,20.7,1458.8,36,2,1,9,4,4,1,0,1,0,17215,7.4,19727,225,51,2627,4080,22.5,1721.5
4445701647,1,74,3,0,10,7,9,1,0,1,0,18209,7.2,18851,209,50,2343,2878,20.9,1820.9,17,3,1,7,10,8,1,1,0,0,15866,6.4,15973,170,54,-2343,-2878,17.0,1586.6
4485702742,1,15,0,1,9,2,5,1,1,0,0,18079,7.2,19818,272,52,3854,2379,27.2,1807.9,15,1,0,2,9,1,0,0,0,0,14225,6.8,17439,230,41,-3854,-2379,23.0,1422.5
4521845032,0,16,5,1,4,8,7,0,0,0,0,15667,7.0,17592,225,60,-2450,-2260,22.5,1566.7,14,3,0,8,4,14,1,1,0,0,18117,7.6,19852,252,60,2450,2260,25.2,1811.7
4490184459,0,18,2,0,5,9,7,0,0,0,0,15089,6.4,16002,182,32,-2349,-2678,18.2,1508.9,17,4,1,9,5,7,1,1,0,0,17438,7.0,18680,201,54,2349,2678,20.1,1743.8
4522301091,1,18,5,1,7,6,6,0,0,0,0,15954,6.8,16128,211,27,654,823,21.1,1595.4,20,1,0,6,7,6,1,0,1,0,15300,6.2,15305,190,40,-654,-823,19.0,1530.0
4511071650,0,15,0,0,4,12,5,0,0,0,0,14799,6.6,15917,218,35,-4740,-3081,21.8,1479.9,16,2,1,12,4,8,2,1,1,0,19539,7.0,18998,231,69,4740,3081,23.1,1953.9
4451891772,0,15,3,0,7,9,4,0,0,0,0,15002,6.4,15784,170,37,-3255,-1798,17.0,1500.2,14,4,1,9,7,10,1,1,0,0,18257,7.0,17582,240,46,3255,1798,24.0,1825.7
